qtl_subset	qtl_ss	qtl_ss_index	qtl_credible_set_or_perm
Alasoo_2018.macrophage_IFNg+Salmonella_ge	/gpfs/hpc/projects/eQTLCatalogue/qtlmap/eQTL_Catalogue_r4/manuscript_sumstats/Alasoo_2018.macrophage_IFNg+Salmonella_ge.nominal.sorted.tsv.gz	/gpfs/hpc/projects/eQTLCatalogue/qtlmap/eQTL_Catalogue_r4/manuscript_sumstats/Alasoo_2018.macrophage_IFNg+Salmonella_ge.nominal.sorted.tsv.gz.tbi	/gpfs/hpc/projects/eQTLCatalogue/qtlmap/eQTL_Catalogue_r4/manuscript_sumstats/Alasoo_2018.macrophage_IFNg+Salmonella_ge.permuted.txt.gz
Alasoo_2018.macrophage_IFNg_ge	/gpfs/hpc/projects/eQTLCatalogue/qtlmap/eQTL_Catalogue_r4/manuscript_sumstats/Alasoo_2018.macrophage_IFNg_ge.nominal.sorted.tsv.gz	/gpfs/hpc/projects/eQTLCatalogue/qtlmap/eQTL_Catalogue_r4/manuscript_sumstats/Alasoo_2018.macrophage_IFNg_ge.nominal.sorted.tsv.gz.tbi	/gpfs/hpc/projects/eQTLCatalogue/qtlmap/eQTL_Catalogue_r4/manuscript_sumstats/Alasoo_2018.macrophage_IFNg_ge.permuted.txt.gz
Alasoo_2018.macrophage_Salmonella_ge	/gpfs/hpc/projects/eQTLCatalogue/qtlmap/eQTL_Catalogue_r4/manuscript_sumstats/Alasoo_2018.macrophage_Salmonella_ge.nominal.sorted.tsv.gz	/gpfs/hpc/projects/eQTLCatalogue/qtlmap/eQTL_Catalogue_r4/manuscript_sumstats/Alasoo_2018.macrophage_Salmonella_ge.nominal.sorted.tsv.gz.tbi	/gpfs/hpc/projects/eQTLCatalogue/qtlmap/eQTL_Catalogue_r4/manuscript_sumstats/Alasoo_2018.macrophage_Salmonella_ge.permuted.txt.gz
Alasoo_2018.macrophage_naive_ge	/gpfs/hpc/projects/eQTLCatalogue/qtlmap/eQTL_Catalogue_r4/manuscript_sumstats/Alasoo_2018.macrophage_naive_ge.nominal.sorted.tsv.gz	/gpfs/hpc/projects/eQTLCatalogue/qtlmap/eQTL_Catalogue_r4/manuscript_sumstats/Alasoo_2018.macrophage_naive_ge.nominal.sorted.tsv.gz.tbi	/gpfs/hpc/projects/eQTLCatalogue/qtlmap/eQTL_Catalogue_r4/manuscript_sumstats/Alasoo_2018.macrophage_naive_ge.permuted.txt.gz
BLUEPRINT_PE.T-cell_ge	/gpfs/hpc/projects/eQTLCatalogue/qtlmap/eQTL_Catalogue_r4/manuscript_sumstats/BLUEPRINT_PE.T-cell_ge.nominal.sorted.tsv.gz	/gpfs/hpc/projects/eQTLCatalogue/qtlmap/eQTL_Catalogue_r4/manuscript_sumstats/BLUEPRINT_PE.T-cell_ge.nominal.sorted.tsv.gz.tbi	/gpfs/hpc/projects/eQTLCatalogue/qtlmap/eQTL_Catalogue_r4/manuscript_sumstats/BLUEPRINT_PE.T-cell_ge.permuted.txt.gz
BLUEPRINT_SE.monocyte_ge	/gpfs/hpc/projects/eQTLCatalogue/qtlmap/eQTL_Catalogue_r4/manuscript_sumstats/BLUEPRINT_SE.monocyte_ge.nominal.sorted.tsv.gz	/gpfs/hpc/projects/eQTLCatalogue/qtlmap/eQTL_Catalogue_r4/manuscript_sumstats/BLUEPRINT_SE.monocyte_ge.nominal.sorted.tsv.gz.tbi	/gpfs/hpc/projects/eQTLCatalogue/qtlmap/eQTL_Catalogue_r4/manuscript_sumstats/BLUEPRINT_SE.monocyte_ge.permuted.txt.gz
BLUEPRINT_SE.neutrophil_ge	/gpfs/hpc/projects/eQTLCatalogue/qtlmap/eQTL_Catalogue_r4/manuscript_sumstats/BLUEPRINT_SE.neutrophil_ge.nominal.sorted.tsv.gz	/gpfs/hpc/projects/eQTLCatalogue/qtlmap/eQTL_Catalogue_r4/manuscript_sumstats/BLUEPRINT_SE.neutrophil_ge.nominal.sorted.tsv.gz.tbi	/gpfs/hpc/projects/eQTLCatalogue/qtlmap/eQTL_Catalogue_r4/manuscript_sumstats/BLUEPRINT_SE.neutrophil_ge.permuted.txt.gz
BrainSeq.brain_ge	/gpfs/hpc/projects/eQTLCatalogue/qtlmap/eQTL_Catalogue_r4/manuscript_sumstats/BrainSeq.brain_ge.nominal.sorted.tsv.gz	/gpfs/hpc/projects/eQTLCatalogue/qtlmap/eQTL_Catalogue_r4/manuscript_sumstats/BrainSeq.brain_ge.nominal.sorted.tsv.gz.tbi	/gpfs/hpc/projects/eQTLCatalogue/qtlmap/eQTL_Catalogue_r4/manuscript_sumstats/BrainSeq.brain_ge.permuted.txt.gz
FUSION.adipose_naive_ge	/gpfs/hpc/projects/eQTLCatalogue/qtlmap/eQTL_Catalogue_r4/manuscript_sumstats/FUSION.adipose_naive_ge.nominal.sorted.tsv.gz	/gpfs/hpc/projects/eQTLCatalogue/qtlmap/eQTL_Catalogue_r4/manuscript_sumstats/FUSION.adipose_naive_ge.nominal.sorted.tsv.gz.tbi	/gpfs/hpc/projects/eQTLCatalogue/qtlmap/eQTL_Catalogue_r4/manuscript_sumstats/FUSION.adipose_naive_ge.permuted.txt.gz
FUSION.muscle_naive_ge	/gpfs/hpc/projects/eQTLCatalogue/qtlmap/eQTL_Catalogue_r4/manuscript_sumstats/FUSION.muscle_naive_ge.nominal.sorted.tsv.gz	/gpfs/hpc/projects/eQTLCatalogue/qtlmap/eQTL_Catalogue_r4/manuscript_sumstats/FUSION.muscle_naive_ge.nominal.sorted.tsv.gz.tbi	/gpfs/hpc/projects/eQTLCatalogue/qtlmap/eQTL_Catalogue_r4/manuscript_sumstats/FUSION.muscle_naive_ge.permuted.txt.gz
GENCORD.LCL_ge	/gpfs/hpc/projects/eQTLCatalogue/qtlmap/eQTL_Catalogue_r4/manuscript_sumstats/GENCORD.LCL_ge.nominal.sorted.tsv.gz	/gpfs/hpc/projects/eQTLCatalogue/qtlmap/eQTL_Catalogue_r4/manuscript_sumstats/GENCORD.LCL_ge.nominal.sorted.tsv.gz.tbi	/gpfs/hpc/projects/eQTLCatalogue/qtlmap/eQTL_Catalogue_r4/manuscript_sumstats/GENCORD.LCL_ge.permuted.txt.gz
GENCORD.T-cell_ge	/gpfs/hpc/projects/eQTLCatalogue/qtlmap/eQTL_Catalogue_r4/manuscript_sumstats/GENCORD.T-cell_ge.nominal.sorted.tsv.gz	/gpfs/hpc/projects/eQTLCatalogue/qtlmap/eQTL_Catalogue_r4/manuscript_sumstats/GENCORD.T-cell_ge.nominal.sorted.tsv.gz.tbi	/gpfs/hpc/projects/eQTLCatalogue/qtlmap/eQTL_Catalogue_r4/manuscript_sumstats/GENCORD.T-cell_ge.permuted.txt.gz
GENCORD.fibroblast_ge	/gpfs/hpc/projects/eQTLCatalogue/qtlmap/eQTL_Catalogue_r4/manuscript_sumstats/GENCORD.fibroblast_ge.nominal.sorted.tsv.gz	/gpfs/hpc/projects/eQTLCatalogue/qtlmap/eQTL_Catalogue_r4/manuscript_sumstats/GENCORD.fibroblast_ge.nominal.sorted.tsv.gz.tbi	/gpfs/hpc/projects/eQTLCatalogue/qtlmap/eQTL_Catalogue_r4/manuscript_sumstats/GENCORD.fibroblast_ge.permuted.txt.gz
GEUVADIS.LCL_ge	/gpfs/hpc/projects/eQTLCatalogue/qtlmap/eQTL_Catalogue_r4/manuscript_sumstats/GEUVADIS.LCL_ge.nominal.sorted.tsv.gz	/gpfs/hpc/projects/eQTLCatalogue/qtlmap/eQTL_Catalogue_r4/manuscript_sumstats/GEUVADIS.LCL_ge.nominal.sorted.tsv.gz.tbi	/gpfs/hpc/projects/eQTLCatalogue/qtlmap/eQTL_Catalogue_r4/manuscript_sumstats/GEUVADIS.LCL_ge.permuted.txt.gz
GTExV8.LCL_ge	/gpfs/hpc/projects/eQTLCatalogue/qtlmap/eQTL_Catalogue_r4/manuscript_sumstats/GTExV8.LCL_ge.nominal.sorted.tsv.gz	/gpfs/hpc/projects/eQTLCatalogue/qtlmap/eQTL_Catalogue_r4/manuscript_sumstats/GTExV8.LCL_ge.nominal.sorted.tsv.gz.tbi	/gpfs/hpc/projects/eQTLCatalogue/qtlmap/eQTL_Catalogue_r4/manuscript_sumstats/GTExV8.LCL_ge.permuted.txt.gz
GTExV8.adipose_subcutaneous_ge	/gpfs/hpc/projects/eQTLCatalogue/qtlmap/eQTL_Catalogue_r4/manuscript_sumstats/GTExV8.adipose_subcutaneous_ge.nominal.sorted.tsv.gz	/gpfs/hpc/projects/eQTLCatalogue/qtlmap/eQTL_Catalogue_r4/manuscript_sumstats/GTExV8.adipose_subcutaneous_ge.nominal.sorted.tsv.gz.tbi	/gpfs/hpc/projects/eQTLCatalogue/qtlmap/eQTL_Catalogue_r4/manuscript_sumstats/GTExV8.adipose_subcutaneous_ge.permuted.txt.gz
GTExV8.adipose_visceral_ge	/gpfs/hpc/projects/eQTLCatalogue/qtlmap/eQTL_Catalogue_r4/manuscript_sumstats/GTExV8.adipose_visceral_ge.nominal.sorted.tsv.gz	/gpfs/hpc/projects/eQTLCatalogue/qtlmap/eQTL_Catalogue_r4/manuscript_sumstats/GTExV8.adipose_visceral_ge.nominal.sorted.tsv.gz.tbi	/gpfs/hpc/projects/eQTLCatalogue/qtlmap/eQTL_Catalogue_r4/manuscript_sumstats/GTExV8.adipose_visceral_ge.permuted.txt.gz
GTExV8.adrenal_gland_ge	/gpfs/hpc/projects/eQTLCatalogue/qtlmap/eQTL_Catalogue_r4/manuscript_sumstats/GTExV8.adrenal_gland_ge.nominal.sorted.tsv.gz	/gpfs/hpc/projects/eQTLCatalogue/qtlmap/eQTL_Catalogue_r4/manuscript_sumstats/GTExV8.adrenal_gland_ge.nominal.sorted.tsv.gz.tbi	/gpfs/hpc/projects/eQTLCatalogue/qtlmap/eQTL_Catalogue_r4/manuscript_sumstats/GTExV8.adrenal_gland_ge.permuted.txt.gz
GTExV8.artery_aorta_ge	/gpfs/hpc/projects/eQTLCatalogue/qtlmap/eQTL_Catalogue_r4/manuscript_sumstats/GTExV8.artery_aorta_ge.nominal.sorted.tsv.gz	/gpfs/hpc/projects/eQTLCatalogue/qtlmap/eQTL_Catalogue_r4/manuscript_sumstats/GTExV8.artery_aorta_ge.nominal.sorted.tsv.gz.tbi	/gpfs/hpc/projects/eQTLCatalogue/qtlmap/eQTL_Catalogue_r4/manuscript_sumstats/GTExV8.artery_aorta_ge.permuted.txt.gz
GTExV8.artery_coronary_ge	/gpfs/hpc/projects/eQTLCatalogue/qtlmap/eQTL_Catalogue_r4/manuscript_sumstats/GTExV8.artery_coronary_ge.nominal.sorted.tsv.gz	/gpfs/hpc/projects/eQTLCatalogue/qtlmap/eQTL_Catalogue_r4/manuscript_sumstats/GTExV8.artery_coronary_ge.nominal.sorted.tsv.gz.tbi	/gpfs/hpc/projects/eQTLCatalogue/qtlmap/eQTL_Catalogue_r4/manuscript_sumstats/GTExV8.artery_coronary_ge.permuted.txt.gz
GTExV8.artery_tibial_ge	/gpfs/hpc/projects/eQTLCatalogue/qtlmap/eQTL_Catalogue_r4/manuscript_sumstats/GTExV8.artery_tibial_ge.nominal.sorted.tsv.gz	/gpfs/hpc/projects/eQTLCatalogue/qtlmap/eQTL_Catalogue_r4/manuscript_sumstats/GTExV8.artery_tibial_ge.nominal.sorted.tsv.gz.tbi	/gpfs/hpc/projects/eQTLCatalogue/qtlmap/eQTL_Catalogue_r4/manuscript_sumstats/GTExV8.artery_tibial_ge.permuted.txt.gz
GTExV8.blood_ge	/gpfs/hpc/projects/eQTLCatalogue/qtlmap/eQTL_Catalogue_r4/manuscript_sumstats/GTExV8.blood_ge.nominal.sorted.tsv.gz	/gpfs/hpc/projects/eQTLCatalogue/qtlmap/eQTL_Catalogue_r4/manuscript_sumstats/GTExV8.blood_ge.nominal.sorted.tsv.gz.tbi	/gpfs/hpc/projects/eQTLCatalogue/qtlmap/eQTL_Catalogue_r4/manuscript_sumstats/GTExV8.blood_ge.permuted.txt.gz
GTExV8.brain_amygdala_ge	/gpfs/hpc/projects/eQTLCatalogue/qtlmap/eQTL_Catalogue_r4/manuscript_sumstats/GTExV8.brain_amygdala_ge.nominal.sorted.tsv.gz	/gpfs/hpc/projects/eQTLCatalogue/qtlmap/eQTL_Catalogue_r4/manuscript_sumstats/GTExV8.brain_amygdala_ge.nominal.sorted.tsv.gz.tbi	/gpfs/hpc/projects/eQTLCatalogue/qtlmap/eQTL_Catalogue_r4/manuscript_sumstats/GTExV8.brain_amygdala_ge.permuted.txt.gz
GTExV8.brain_anterior_cingulate_cortex_ge	/gpfs/hpc/projects/eQTLCatalogue/qtlmap/eQTL_Catalogue_r4/manuscript_sumstats/GTExV8.brain_anterior_cingulate_cortex_ge.nominal.sorted.tsv.gz	/gpfs/hpc/projects/eQTLCatalogue/qtlmap/eQTL_Catalogue_r4/manuscript_sumstats/GTExV8.brain_anterior_cingulate_cortex_ge.nominal.sorted.tsv.gz.tbi	/gpfs/hpc/projects/eQTLCatalogue/qtlmap/eQTL_Catalogue_r4/manuscript_sumstats/GTExV8.brain_anterior_cingulate_cortex_ge.permuted.txt.gz
GTExV8.brain_caudate_ge	/gpfs/hpc/projects/eQTLCatalogue/qtlmap/eQTL_Catalogue_r4/manuscript_sumstats/GTExV8.brain_caudate_ge.nominal.sorted.tsv.gz	/gpfs/hpc/projects/eQTLCatalogue/qtlmap/eQTL_Catalogue_r4/manuscript_sumstats/GTExV8.brain_caudate_ge.nominal.sorted.tsv.gz.tbi	/gpfs/hpc/projects/eQTLCatalogue/qtlmap/eQTL_Catalogue_r4/manuscript_sumstats/GTExV8.brain_caudate_ge.permuted.txt.gz
GTExV8.brain_cerebellar_hemisphere_ge	/gpfs/hpc/projects/eQTLCatalogue/qtlmap/eQTL_Catalogue_r4/manuscript_sumstats/GTExV8.brain_cerebellar_hemisphere_ge.nominal.sorted.tsv.gz	/gpfs/hpc/projects/eQTLCatalogue/qtlmap/eQTL_Catalogue_r4/manuscript_sumstats/GTExV8.brain_cerebellar_hemisphere_ge.nominal.sorted.tsv.gz.tbi	/gpfs/hpc/projects/eQTLCatalogue/qtlmap/eQTL_Catalogue_r4/manuscript_sumstats/GTExV8.brain_cerebellar_hemisphere_ge.permuted.txt.gz
GTExV8.brain_cerebellum_ge	/gpfs/hpc/projects/eQTLCatalogue/qtlmap/eQTL_Catalogue_r4/manuscript_sumstats/GTExV8.brain_cerebellum_ge.nominal.sorted.tsv.gz	/gpfs/hpc/projects/eQTLCatalogue/qtlmap/eQTL_Catalogue_r4/manuscript_sumstats/GTExV8.brain_cerebellum_ge.nominal.sorted.tsv.gz.tbi	/gpfs/hpc/projects/eQTLCatalogue/qtlmap/eQTL_Catalogue_r4/manuscript_sumstats/GTExV8.brain_cerebellum_ge.permuted.txt.gz
GTExV8.brain_cortex_ge	/gpfs/hpc/projects/eQTLCatalogue/qtlmap/eQTL_Catalogue_r4/manuscript_sumstats/GTExV8.brain_cortex_ge.nominal.sorted.tsv.gz	/gpfs/hpc/projects/eQTLCatalogue/qtlmap/eQTL_Catalogue_r4/manuscript_sumstats/GTExV8.brain_cortex_ge.nominal.sorted.tsv.gz.tbi	/gpfs/hpc/projects/eQTLCatalogue/qtlmap/eQTL_Catalogue_r4/manuscript_sumstats/GTExV8.brain_cortex_ge.permuted.txt.gz
GTExV8.brain_frontal_cortex_ge	/gpfs/hpc/projects/eQTLCatalogue/qtlmap/eQTL_Catalogue_r4/manuscript_sumstats/GTExV8.brain_frontal_cortex_ge.nominal.sorted.tsv.gz	/gpfs/hpc/projects/eQTLCatalogue/qtlmap/eQTL_Catalogue_r4/manuscript_sumstats/GTExV8.brain_frontal_cortex_ge.nominal.sorted.tsv.gz.tbi	/gpfs/hpc/projects/eQTLCatalogue/qtlmap/eQTL_Catalogue_r4/manuscript_sumstats/GTExV8.brain_frontal_cortex_ge.permuted.txt.gz
GTExV8.brain_hippocampus_ge	/gpfs/hpc/projects/eQTLCatalogue/qtlmap/eQTL_Catalogue_r4/manuscript_sumstats/GTExV8.brain_hippocampus_ge.nominal.sorted.tsv.gz	/gpfs/hpc/projects/eQTLCatalogue/qtlmap/eQTL_Catalogue_r4/manuscript_sumstats/GTExV8.brain_hippocampus_ge.nominal.sorted.tsv.gz.tbi	/gpfs/hpc/projects/eQTLCatalogue/qtlmap/eQTL_Catalogue_r4/manuscript_sumstats/GTExV8.brain_hippocampus_ge.permuted.txt.gz
GTExV8.brain_hypothalamus_ge	/gpfs/hpc/projects/eQTLCatalogue/qtlmap/eQTL_Catalogue_r4/manuscript_sumstats/GTExV8.brain_hypothalamus_ge.nominal.sorted.tsv.gz	/gpfs/hpc/projects/eQTLCatalogue/qtlmap/eQTL_Catalogue_r4/manuscript_sumstats/GTExV8.brain_hypothalamus_ge.nominal.sorted.tsv.gz.tbi	/gpfs/hpc/projects/eQTLCatalogue/qtlmap/eQTL_Catalogue_r4/manuscript_sumstats/GTExV8.brain_hypothalamus_ge.permuted.txt.gz
GTExV8.brain_nucleus_accumbens_ge	/gpfs/hpc/projects/eQTLCatalogue/qtlmap/eQTL_Catalogue_r4/manuscript_sumstats/GTExV8.brain_nucleus_accumbens_ge.nominal.sorted.tsv.gz	/gpfs/hpc/projects/eQTLCatalogue/qtlmap/eQTL_Catalogue_r4/manuscript_sumstats/GTExV8.brain_nucleus_accumbens_ge.nominal.sorted.tsv.gz.tbi	/gpfs/hpc/projects/eQTLCatalogue/qtlmap/eQTL_Catalogue_r4/manuscript_sumstats/GTExV8.brain_nucleus_accumbens_ge.permuted.txt.gz
GTExV8.brain_putamen_ge	/gpfs/hpc/projects/eQTLCatalogue/qtlmap/eQTL_Catalogue_r4/manuscript_sumstats/GTExV8.brain_putamen_ge.nominal.sorted.tsv.gz	/gpfs/hpc/projects/eQTLCatalogue/qtlmap/eQTL_Catalogue_r4/manuscript_sumstats/GTExV8.brain_putamen_ge.nominal.sorted.tsv.gz.tbi	/gpfs/hpc/projects/eQTLCatalogue/qtlmap/eQTL_Catalogue_r4/manuscript_sumstats/GTExV8.brain_putamen_ge.permuted.txt.gz
GTExV8.brain_spinal_cord_ge	/gpfs/hpc/projects/eQTLCatalogue/qtlmap/eQTL_Catalogue_r4/manuscript_sumstats/GTExV8.brain_spinal_cord_ge.nominal.sorted.tsv.gz	/gpfs/hpc/projects/eQTLCatalogue/qtlmap/eQTL_Catalogue_r4/manuscript_sumstats/GTExV8.brain_spinal_cord_ge.nominal.sorted.tsv.gz.tbi	/gpfs/hpc/projects/eQTLCatalogue/qtlmap/eQTL_Catalogue_r4/manuscript_sumstats/GTExV8.brain_spinal_cord_ge.permuted.txt.gz
GTExV8.brain_substantia_nigra_ge	/gpfs/hpc/projects/eQTLCatalogue/qtlmap/eQTL_Catalogue_r4/manuscript_sumstats/GTExV8.brain_substantia_nigra_ge.nominal.sorted.tsv.gz	/gpfs/hpc/projects/eQTLCatalogue/qtlmap/eQTL_Catalogue_r4/manuscript_sumstats/GTExV8.brain_substantia_nigra_ge.nominal.sorted.tsv.gz.tbi	/gpfs/hpc/projects/eQTLCatalogue/qtlmap/eQTL_Catalogue_r4/manuscript_sumstats/GTExV8.brain_substantia_nigra_ge.permuted.txt.gz
GTExV8.breast_ge	/gpfs/hpc/projects/eQTLCatalogue/qtlmap/eQTL_Catalogue_r4/manuscript_sumstats/GTExV8.breast_ge.nominal.sorted.tsv.gz	/gpfs/hpc/projects/eQTLCatalogue/qtlmap/eQTL_Catalogue_r4/manuscript_sumstats/GTExV8.breast_ge.nominal.sorted.tsv.gz.tbi	/gpfs/hpc/projects/eQTLCatalogue/qtlmap/eQTL_Catalogue_r4/manuscript_sumstats/GTExV8.breast_ge.permuted.txt.gz
GTExV8.colon_sigmoid_ge	/gpfs/hpc/projects/eQTLCatalogue/qtlmap/eQTL_Catalogue_r4/manuscript_sumstats/GTExV8.colon_sigmoid_ge.nominal.sorted.tsv.gz	/gpfs/hpc/projects/eQTLCatalogue/qtlmap/eQTL_Catalogue_r4/manuscript_sumstats/GTExV8.colon_sigmoid_ge.nominal.sorted.tsv.gz.tbi	/gpfs/hpc/projects/eQTLCatalogue/qtlmap/eQTL_Catalogue_r4/manuscript_sumstats/GTExV8.colon_sigmoid_ge.permuted.txt.gz
GTExV8.colon_transverse_ge	/gpfs/hpc/projects/eQTLCatalogue/qtlmap/eQTL_Catalogue_r4/manuscript_sumstats/GTExV8.colon_transverse_ge.nominal.sorted.tsv.gz	/gpfs/hpc/projects/eQTLCatalogue/qtlmap/eQTL_Catalogue_r4/manuscript_sumstats/GTExV8.colon_transverse_ge.nominal.sorted.tsv.gz.tbi	/gpfs/hpc/projects/eQTLCatalogue/qtlmap/eQTL_Catalogue_r4/manuscript_sumstats/GTExV8.colon_transverse_ge.permuted.txt.gz
GTExV8.esophagus_gej_ge	/gpfs/hpc/projects/eQTLCatalogue/qtlmap/eQTL_Catalogue_r4/manuscript_sumstats/GTExV8.esophagus_gej_ge.nominal.sorted.tsv.gz	/gpfs/hpc/projects/eQTLCatalogue/qtlmap/eQTL_Catalogue_r4/manuscript_sumstats/GTExV8.esophagus_gej_ge.nominal.sorted.tsv.gz.tbi	/gpfs/hpc/projects/eQTLCatalogue/qtlmap/eQTL_Catalogue_r4/manuscript_sumstats/GTExV8.esophagus_gej_ge.permuted.txt.gz
GTExV8.esophagus_mucosa_ge	/gpfs/hpc/projects/eQTLCatalogue/qtlmap/eQTL_Catalogue_r4/manuscript_sumstats/GTExV8.esophagus_mucosa_ge.nominal.sorted.tsv.gz	/gpfs/hpc/projects/eQTLCatalogue/qtlmap/eQTL_Catalogue_r4/manuscript_sumstats/GTExV8.esophagus_mucosa_ge.nominal.sorted.tsv.gz.tbi	/gpfs/hpc/projects/eQTLCatalogue/qtlmap/eQTL_Catalogue_r4/manuscript_sumstats/GTExV8.esophagus_mucosa_ge.permuted.txt.gz
GTExV8.esophagus_muscularis_ge	/gpfs/hpc/projects/eQTLCatalogue/qtlmap/eQTL_Catalogue_r4/manuscript_sumstats/GTExV8.esophagus_muscularis_ge.nominal.sorted.tsv.gz	/gpfs/hpc/projects/eQTLCatalogue/qtlmap/eQTL_Catalogue_r4/manuscript_sumstats/GTExV8.esophagus_muscularis_ge.nominal.sorted.tsv.gz.tbi	/gpfs/hpc/projects/eQTLCatalogue/qtlmap/eQTL_Catalogue_r4/manuscript_sumstats/GTExV8.esophagus_muscularis_ge.permuted.txt.gz
GTExV8.fibroblast_ge	/gpfs/hpc/projects/eQTLCatalogue/qtlmap/eQTL_Catalogue_r4/manuscript_sumstats/GTExV8.fibroblast_ge.nominal.sorted.tsv.gz	/gpfs/hpc/projects/eQTLCatalogue/qtlmap/eQTL_Catalogue_r4/manuscript_sumstats/GTExV8.fibroblast_ge.nominal.sorted.tsv.gz.tbi	/gpfs/hpc/projects/eQTLCatalogue/qtlmap/eQTL_Catalogue_r4/manuscript_sumstats/GTExV8.fibroblast_ge.permuted.txt.gz
GTExV8.heart_atrial_appendage_ge	/gpfs/hpc/projects/eQTLCatalogue/qtlmap/eQTL_Catalogue_r4/manuscript_sumstats/GTExV8.heart_atrial_appendage_ge.nominal.sorted.tsv.gz	/gpfs/hpc/projects/eQTLCatalogue/qtlmap/eQTL_Catalogue_r4/manuscript_sumstats/GTExV8.heart_atrial_appendage_ge.nominal.sorted.tsv.gz.tbi	/gpfs/hpc/projects/eQTLCatalogue/qtlmap/eQTL_Catalogue_r4/manuscript_sumstats/GTExV8.heart_atrial_appendage_ge.permuted.txt.gz
GTExV8.heart_left_ventricle_ge	/gpfs/hpc/projects/eQTLCatalogue/qtlmap/eQTL_Catalogue_r4/manuscript_sumstats/GTExV8.heart_left_ventricle_ge.nominal.sorted.tsv.gz	/gpfs/hpc/projects/eQTLCatalogue/qtlmap/eQTL_Catalogue_r4/manuscript_sumstats/GTExV8.heart_left_ventricle_ge.nominal.sorted.tsv.gz.tbi	/gpfs/hpc/projects/eQTLCatalogue/qtlmap/eQTL_Catalogue_r4/manuscript_sumstats/GTExV8.heart_left_ventricle_ge.permuted.txt.gz
GTExV8.kidney_cortex_ge	/gpfs/hpc/projects/eQTLCatalogue/qtlmap/eQTL_Catalogue_r4/manuscript_sumstats/GTExV8.kidney_cortex_ge.nominal.sorted.tsv.gz	/gpfs/hpc/projects/eQTLCatalogue/qtlmap/eQTL_Catalogue_r4/manuscript_sumstats/GTExV8.kidney_cortex_ge.nominal.sorted.tsv.gz.tbi	/gpfs/hpc/projects/eQTLCatalogue/qtlmap/eQTL_Catalogue_r4/manuscript_sumstats/GTExV8.kidney_cortex_ge.permuted.txt.gz
GTExV8.liver_ge	/gpfs/hpc/projects/eQTLCatalogue/qtlmap/eQTL_Catalogue_r4/manuscript_sumstats/GTExV8.liver_ge.nominal.sorted.tsv.gz	/gpfs/hpc/projects/eQTLCatalogue/qtlmap/eQTL_Catalogue_r4/manuscript_sumstats/GTExV8.liver_ge.nominal.sorted.tsv.gz.tbi	/gpfs/hpc/projects/eQTLCatalogue/qtlmap/eQTL_Catalogue_r4/manuscript_sumstats/GTExV8.liver_ge.permuted.txt.gz
GTExV8.lung_ge	/gpfs/hpc/projects/eQTLCatalogue/qtlmap/eQTL_Catalogue_r4/manuscript_sumstats/GTExV8.lung_ge.nominal.sorted.tsv.gz	/gpfs/hpc/projects/eQTLCatalogue/qtlmap/eQTL_Catalogue_r4/manuscript_sumstats/GTExV8.lung_ge.nominal.sorted.tsv.gz.tbi	/gpfs/hpc/projects/eQTLCatalogue/qtlmap/eQTL_Catalogue_r4/manuscript_sumstats/GTExV8.lung_ge.permuted.txt.gz
GTExV8.minor_salivary_gland_ge	/gpfs/hpc/projects/eQTLCatalogue/qtlmap/eQTL_Catalogue_r4/manuscript_sumstats/GTExV8.minor_salivary_gland_ge.nominal.sorted.tsv.gz	/gpfs/hpc/projects/eQTLCatalogue/qtlmap/eQTL_Catalogue_r4/manuscript_sumstats/GTExV8.minor_salivary_gland_ge.nominal.sorted.tsv.gz.tbi	/gpfs/hpc/projects/eQTLCatalogue/qtlmap/eQTL_Catalogue_r4/manuscript_sumstats/GTExV8.minor_salivary_gland_ge.permuted.txt.gz
GTExV8.muscle_ge	/gpfs/hpc/projects/eQTLCatalogue/qtlmap/eQTL_Catalogue_r4/manuscript_sumstats/GTExV8.muscle_ge.nominal.sorted.tsv.gz	/gpfs/hpc/projects/eQTLCatalogue/qtlmap/eQTL_Catalogue_r4/manuscript_sumstats/GTExV8.muscle_ge.nominal.sorted.tsv.gz.tbi	/gpfs/hpc/projects/eQTLCatalogue/qtlmap/eQTL_Catalogue_r4/manuscript_sumstats/GTExV8.muscle_ge.permuted.txt.gz
GTExV8.nerve_tibial_ge	/gpfs/hpc/projects/eQTLCatalogue/qtlmap/eQTL_Catalogue_r4/manuscript_sumstats/GTExV8.nerve_tibial_ge.nominal.sorted.tsv.gz	/gpfs/hpc/projects/eQTLCatalogue/qtlmap/eQTL_Catalogue_r4/manuscript_sumstats/GTExV8.nerve_tibial_ge.nominal.sorted.tsv.gz.tbi	/gpfs/hpc/projects/eQTLCatalogue/qtlmap/eQTL_Catalogue_r4/manuscript_sumstats/GTExV8.nerve_tibial_ge.permuted.txt.gz
GTExV8.ovary_ge	/gpfs/hpc/projects/eQTLCatalogue/qtlmap/eQTL_Catalogue_r4/manuscript_sumstats/GTExV8.ovary_ge.nominal.sorted.tsv.gz	/gpfs/hpc/projects/eQTLCatalogue/qtlmap/eQTL_Catalogue_r4/manuscript_sumstats/GTExV8.ovary_ge.nominal.sorted.tsv.gz.tbi	/gpfs/hpc/projects/eQTLCatalogue/qtlmap/eQTL_Catalogue_r4/manuscript_sumstats/GTExV8.ovary_ge.permuted.txt.gz
GTExV8.pancreas_ge	/gpfs/hpc/projects/eQTLCatalogue/qtlmap/eQTL_Catalogue_r4/manuscript_sumstats/GTExV8.pancreas_ge.nominal.sorted.tsv.gz	/gpfs/hpc/projects/eQTLCatalogue/qtlmap/eQTL_Catalogue_r4/manuscript_sumstats/GTExV8.pancreas_ge.nominal.sorted.tsv.gz.tbi	/gpfs/hpc/projects/eQTLCatalogue/qtlmap/eQTL_Catalogue_r4/manuscript_sumstats/GTExV8.pancreas_ge.permuted.txt.gz
GTExV8.pituitary_ge	/gpfs/hpc/projects/eQTLCatalogue/qtlmap/eQTL_Catalogue_r4/manuscript_sumstats/GTExV8.pituitary_ge.nominal.sorted.tsv.gz	/gpfs/hpc/projects/eQTLCatalogue/qtlmap/eQTL_Catalogue_r4/manuscript_sumstats/GTExV8.pituitary_ge.nominal.sorted.tsv.gz.tbi	/gpfs/hpc/projects/eQTLCatalogue/qtlmap/eQTL_Catalogue_r4/manuscript_sumstats/GTExV8.pituitary_ge.permuted.txt.gz
GTExV8.prostate_ge	/gpfs/hpc/projects/eQTLCatalogue/qtlmap/eQTL_Catalogue_r4/manuscript_sumstats/GTExV8.prostate_ge.nominal.sorted.tsv.gz	/gpfs/hpc/projects/eQTLCatalogue/qtlmap/eQTL_Catalogue_r4/manuscript_sumstats/GTExV8.prostate_ge.nominal.sorted.tsv.gz.tbi	/gpfs/hpc/projects/eQTLCatalogue/qtlmap/eQTL_Catalogue_r4/manuscript_sumstats/GTExV8.prostate_ge.permuted.txt.gz
GTExV8.skin_not_sun_exposed_ge	/gpfs/hpc/projects/eQTLCatalogue/qtlmap/eQTL_Catalogue_r4/manuscript_sumstats/GTExV8.skin_not_sun_exposed_ge.nominal.sorted.tsv.gz	/gpfs/hpc/projects/eQTLCatalogue/qtlmap/eQTL_Catalogue_r4/manuscript_sumstats/GTExV8.skin_not_sun_exposed_ge.nominal.sorted.tsv.gz.tbi	/gpfs/hpc/projects/eQTLCatalogue/qtlmap/eQTL_Catalogue_r4/manuscript_sumstats/GTExV8.skin_not_sun_exposed_ge.permuted.txt.gz
GTExV8.skin_sun_exposed_ge	/gpfs/hpc/projects/eQTLCatalogue/qtlmap/eQTL_Catalogue_r4/manuscript_sumstats/GTExV8.skin_sun_exposed_ge.nominal.sorted.tsv.gz	/gpfs/hpc/projects/eQTLCatalogue/qtlmap/eQTL_Catalogue_r4/manuscript_sumstats/GTExV8.skin_sun_exposed_ge.nominal.sorted.tsv.gz.tbi	/gpfs/hpc/projects/eQTLCatalogue/qtlmap/eQTL_Catalogue_r4/manuscript_sumstats/GTExV8.skin_sun_exposed_ge.permuted.txt.gz
GTExV8.small_intestine_ge	/gpfs/hpc/projects/eQTLCatalogue/qtlmap/eQTL_Catalogue_r4/manuscript_sumstats/GTExV8.small_intestine_ge.nominal.sorted.tsv.gz	/gpfs/hpc/projects/eQTLCatalogue/qtlmap/eQTL_Catalogue_r4/manuscript_sumstats/GTExV8.small_intestine_ge.nominal.sorted.tsv.gz.tbi	/gpfs/hpc/projects/eQTLCatalogue/qtlmap/eQTL_Catalogue_r4/manuscript_sumstats/GTExV8.small_intestine_ge.permuted.txt.gz
GTExV8.spleen_ge	/gpfs/hpc/projects/eQTLCatalogue/qtlmap/eQTL_Catalogue_r4/manuscript_sumstats/GTExV8.spleen_ge.nominal.sorted.tsv.gz	/gpfs/hpc/projects/eQTLCatalogue/qtlmap/eQTL_Catalogue_r4/manuscript_sumstats/GTExV8.spleen_ge.nominal.sorted.tsv.gz.tbi	/gpfs/hpc/projects/eQTLCatalogue/qtlmap/eQTL_Catalogue_r4/manuscript_sumstats/GTExV8.spleen_ge.permuted.txt.gz
GTExV8.stomach_ge	/gpfs/hpc/projects/eQTLCatalogue/qtlmap/eQTL_Catalogue_r4/manuscript_sumstats/GTExV8.stomach_ge.nominal.sorted.tsv.gz	/gpfs/hpc/projects/eQTLCatalogue/qtlmap/eQTL_Catalogue_r4/manuscript_sumstats/GTExV8.stomach_ge.nominal.sorted.tsv.gz.tbi	/gpfs/hpc/projects/eQTLCatalogue/qtlmap/eQTL_Catalogue_r4/manuscript_sumstats/GTExV8.stomach_ge.permuted.txt.gz
GTExV8.testis_ge	/gpfs/hpc/projects/eQTLCatalogue/qtlmap/eQTL_Catalogue_r4/manuscript_sumstats/GTExV8.testis_ge.nominal.sorted.tsv.gz	/gpfs/hpc/projects/eQTLCatalogue/qtlmap/eQTL_Catalogue_r4/manuscript_sumstats/GTExV8.testis_ge.nominal.sorted.tsv.gz.tbi	/gpfs/hpc/projects/eQTLCatalogue/qtlmap/eQTL_Catalogue_r4/manuscript_sumstats/GTExV8.testis_ge.permuted.txt.gz
GTExV8.thyroid_ge	/gpfs/hpc/projects/eQTLCatalogue/qtlmap/eQTL_Catalogue_r4/manuscript_sumstats/GTExV8.thyroid_ge.nominal.sorted.tsv.gz	/gpfs/hpc/projects/eQTLCatalogue/qtlmap/eQTL_Catalogue_r4/manuscript_sumstats/GTExV8.thyroid_ge.nominal.sorted.tsv.gz.tbi	/gpfs/hpc/projects/eQTLCatalogue/qtlmap/eQTL_Catalogue_r4/manuscript_sumstats/GTExV8.thyroid_ge.permuted.txt.gz
GTExV8.uterus_ge	/gpfs/hpc/projects/eQTLCatalogue/qtlmap/eQTL_Catalogue_r4/manuscript_sumstats/GTExV8.uterus_ge.nominal.sorted.tsv.gz	/gpfs/hpc/projects/eQTLCatalogue/qtlmap/eQTL_Catalogue_r4/manuscript_sumstats/GTExV8.uterus_ge.nominal.sorted.tsv.gz.tbi	/gpfs/hpc/projects/eQTLCatalogue/qtlmap/eQTL_Catalogue_r4/manuscript_sumstats/GTExV8.uterus_ge.permuted.txt.gz
GTExV8.vagina_ge	/gpfs/hpc/projects/eQTLCatalogue/qtlmap/eQTL_Catalogue_r4/manuscript_sumstats/GTExV8.vagina_ge.nominal.sorted.tsv.gz	/gpfs/hpc/projects/eQTLCatalogue/qtlmap/eQTL_Catalogue_r4/manuscript_sumstats/GTExV8.vagina_ge.nominal.sorted.tsv.gz.tbi	/gpfs/hpc/projects/eQTLCatalogue/qtlmap/eQTL_Catalogue_r4/manuscript_sumstats/GTExV8.vagina_ge.permuted.txt.gz
HipSci.iPSC_ge	/gpfs/hpc/projects/eQTLCatalogue/qtlmap/eQTL_Catalogue_r4/manuscript_sumstats/HipSci.iPSC_ge.nominal.sorted.tsv.gz	/gpfs/hpc/projects/eQTLCatalogue/qtlmap/eQTL_Catalogue_r4/manuscript_sumstats/HipSci.iPSC_ge.nominal.sorted.tsv.gz.tbi	/gpfs/hpc/projects/eQTLCatalogue/qtlmap/eQTL_Catalogue_r4/manuscript_sumstats/HipSci.iPSC_ge.permuted.txt.gz
Lepik_2017.blood_ge	/gpfs/hpc/projects/eQTLCatalogue/qtlmap/eQTL_Catalogue_r4/manuscript_sumstats/Lepik_2017.blood_ge.nominal.sorted.tsv.gz	/gpfs/hpc/projects/eQTLCatalogue/qtlmap/eQTL_Catalogue_r4/manuscript_sumstats/Lepik_2017.blood_ge.nominal.sorted.tsv.gz.tbi	/gpfs/hpc/projects/eQTLCatalogue/qtlmap/eQTL_Catalogue_r4/manuscript_sumstats/Lepik_2017.blood_ge.permuted.txt.gz
Nedelec_2016.macrophage_Listeria_ge	/gpfs/hpc/projects/eQTLCatalogue/qtlmap/eQTL_Catalogue_r4/manuscript_sumstats/Nedelec_2016.macrophage_Listeria_ge.nominal.sorted.tsv.gz	/gpfs/hpc/projects/eQTLCatalogue/qtlmap/eQTL_Catalogue_r4/manuscript_sumstats/Nedelec_2016.macrophage_Listeria_ge.nominal.sorted.tsv.gz.tbi	/gpfs/hpc/projects/eQTLCatalogue/qtlmap/eQTL_Catalogue_r4/manuscript_sumstats/Nedelec_2016.macrophage_Listeria_ge.permuted.txt.gz
Nedelec_2016.macrophage_Salmonella_ge	/gpfs/hpc/projects/eQTLCatalogue/qtlmap/eQTL_Catalogue_r4/manuscript_sumstats/Nedelec_2016.macrophage_Salmonella_ge.nominal.sorted.tsv.gz	/gpfs/hpc/projects/eQTLCatalogue/qtlmap/eQTL_Catalogue_r4/manuscript_sumstats/Nedelec_2016.macrophage_Salmonella_ge.nominal.sorted.tsv.gz.tbi	/gpfs/hpc/projects/eQTLCatalogue/qtlmap/eQTL_Catalogue_r4/manuscript_sumstats/Nedelec_2016.macrophage_Salmonella_ge.permuted.txt.gz
Nedelec_2016.macrophage_naive_ge	/gpfs/hpc/projects/eQTLCatalogue/qtlmap/eQTL_Catalogue_r4/manuscript_sumstats/Nedelec_2016.macrophage_naive_ge.nominal.sorted.tsv.gz	/gpfs/hpc/projects/eQTLCatalogue/qtlmap/eQTL_Catalogue_r4/manuscript_sumstats/Nedelec_2016.macrophage_naive_ge.nominal.sorted.tsv.gz.tbi	/gpfs/hpc/projects/eQTLCatalogue/qtlmap/eQTL_Catalogue_r4/manuscript_sumstats/Nedelec_2016.macrophage_naive_ge.permuted.txt.gz
Quach_2016.monocyte_IAV_ge	/gpfs/hpc/projects/eQTLCatalogue/qtlmap/eQTL_Catalogue_r4/manuscript_sumstats/Quach_2016.monocyte_IAV_ge.nominal.sorted.tsv.gz	/gpfs/hpc/projects/eQTLCatalogue/qtlmap/eQTL_Catalogue_r4/manuscript_sumstats/Quach_2016.monocyte_IAV_ge.nominal.sorted.tsv.gz.tbi	/gpfs/hpc/projects/eQTLCatalogue/qtlmap/eQTL_Catalogue_r4/manuscript_sumstats/Quach_2016.monocyte_IAV_ge.permuted.txt.gz
Quach_2016.monocyte_LPS_ge	/gpfs/hpc/projects/eQTLCatalogue/qtlmap/eQTL_Catalogue_r4/manuscript_sumstats/Quach_2016.monocyte_LPS_ge.nominal.sorted.tsv.gz	/gpfs/hpc/projects/eQTLCatalogue/qtlmap/eQTL_Catalogue_r4/manuscript_sumstats/Quach_2016.monocyte_LPS_ge.nominal.sorted.tsv.gz.tbi	/gpfs/hpc/projects/eQTLCatalogue/qtlmap/eQTL_Catalogue_r4/manuscript_sumstats/Quach_2016.monocyte_LPS_ge.permuted.txt.gz
Quach_2016.monocyte_Pam3CSK4_ge	/gpfs/hpc/projects/eQTLCatalogue/qtlmap/eQTL_Catalogue_r4/manuscript_sumstats/Quach_2016.monocyte_Pam3CSK4_ge.nominal.sorted.tsv.gz	/gpfs/hpc/projects/eQTLCatalogue/qtlmap/eQTL_Catalogue_r4/manuscript_sumstats/Quach_2016.monocyte_Pam3CSK4_ge.nominal.sorted.tsv.gz.tbi	/gpfs/hpc/projects/eQTLCatalogue/qtlmap/eQTL_Catalogue_r4/manuscript_sumstats/Quach_2016.monocyte_Pam3CSK4_ge.permuted.txt.gz
Quach_2016.monocyte_R848_ge	/gpfs/hpc/projects/eQTLCatalogue/qtlmap/eQTL_Catalogue_r4/manuscript_sumstats/Quach_2016.monocyte_R848_ge.nominal.sorted.tsv.gz	/gpfs/hpc/projects/eQTLCatalogue/qtlmap/eQTL_Catalogue_r4/manuscript_sumstats/Quach_2016.monocyte_R848_ge.nominal.sorted.tsv.gz.tbi	/gpfs/hpc/projects/eQTLCatalogue/qtlmap/eQTL_Catalogue_r4/manuscript_sumstats/Quach_2016.monocyte_R848_ge.permuted.txt.gz
Quach_2016.monocyte_naive_ge	/gpfs/hpc/projects/eQTLCatalogue/qtlmap/eQTL_Catalogue_r4/manuscript_sumstats/Quach_2016.monocyte_naive_ge.nominal.sorted.tsv.gz	/gpfs/hpc/projects/eQTLCatalogue/qtlmap/eQTL_Catalogue_r4/manuscript_sumstats/Quach_2016.monocyte_naive_ge.nominal.sorted.tsv.gz.tbi	/gpfs/hpc/projects/eQTLCatalogue/qtlmap/eQTL_Catalogue_r4/manuscript_sumstats/Quach_2016.monocyte_naive_ge.permuted.txt.gz
ROSMAP.brain_naive_ge	/gpfs/hpc/projects/eQTLCatalogue/qtlmap/eQTL_Catalogue_r4/manuscript_sumstats/ROSMAP.brain_naive_ge.nominal.sorted.tsv.gz	/gpfs/hpc/projects/eQTLCatalogue/qtlmap/eQTL_Catalogue_r4/manuscript_sumstats/ROSMAP.brain_naive_ge.nominal.sorted.tsv.gz.tbi	/gpfs/hpc/projects/eQTLCatalogue/qtlmap/eQTL_Catalogue_r4/manuscript_sumstats/ROSMAP.brain_naive_ge.permuted.txt.gz
Schmiedel_2018.B-cell_naive_ge	/gpfs/hpc/projects/eQTLCatalogue/qtlmap/eQTL_Catalogue_r4/manuscript_sumstats/Schmiedel_2018.B-cell_naive_ge.nominal.sorted.tsv.gz	/gpfs/hpc/projects/eQTLCatalogue/qtlmap/eQTL_Catalogue_r4/manuscript_sumstats/Schmiedel_2018.B-cell_naive_ge.nominal.sorted.tsv.gz.tbi	/gpfs/hpc/projects/eQTLCatalogue/qtlmap/eQTL_Catalogue_r4/manuscript_sumstats/Schmiedel_2018.B-cell_naive_ge.permuted.txt.gz
Schmiedel_2018.CD4_T-cell_anti-CD3-CD28_ge	/gpfs/hpc/projects/eQTLCatalogue/qtlmap/eQTL_Catalogue_r4/manuscript_sumstats/Schmiedel_2018.CD4_T-cell_anti-CD3-CD28_ge.nominal.sorted.tsv.gz	/gpfs/hpc/projects/eQTLCatalogue/qtlmap/eQTL_Catalogue_r4/manuscript_sumstats/Schmiedel_2018.CD4_T-cell_anti-CD3-CD28_ge.nominal.sorted.tsv.gz.tbi	/gpfs/hpc/projects/eQTLCatalogue/qtlmap/eQTL_Catalogue_r4/manuscript_sumstats/Schmiedel_2018.CD4_T-cell_anti-CD3-CD28_ge.permuted.txt.gz
Schmiedel_2018.CD4_T-cell_naive_ge	/gpfs/hpc/projects/eQTLCatalogue/qtlmap/eQTL_Catalogue_r4/manuscript_sumstats/Schmiedel_2018.CD4_T-cell_naive_ge.nominal.sorted.tsv.gz	/gpfs/hpc/projects/eQTLCatalogue/qtlmap/eQTL_Catalogue_r4/manuscript_sumstats/Schmiedel_2018.CD4_T-cell_naive_ge.nominal.sorted.tsv.gz.tbi	/gpfs/hpc/projects/eQTLCatalogue/qtlmap/eQTL_Catalogue_r4/manuscript_sumstats/Schmiedel_2018.CD4_T-cell_naive_ge.permuted.txt.gz
Schmiedel_2018.CD8_T-cell_anti-CD3-CD28_ge	/gpfs/hpc/projects/eQTLCatalogue/qtlmap/eQTL_Catalogue_r4/manuscript_sumstats/Schmiedel_2018.CD8_T-cell_anti-CD3-CD28_ge.nominal.sorted.tsv.gz	/gpfs/hpc/projects/eQTLCatalogue/qtlmap/eQTL_Catalogue_r4/manuscript_sumstats/Schmiedel_2018.CD8_T-cell_anti-CD3-CD28_ge.nominal.sorted.tsv.gz.tbi	/gpfs/hpc/projects/eQTLCatalogue/qtlmap/eQTL_Catalogue_r4/manuscript_sumstats/Schmiedel_2018.CD8_T-cell_anti-CD3-CD28_ge.permuted.txt.gz
Schmiedel_2018.CD8_T-cell_naive_ge	/gpfs/hpc/projects/eQTLCatalogue/qtlmap/eQTL_Catalogue_r4/manuscript_sumstats/Schmiedel_2018.CD8_T-cell_naive_ge.nominal.sorted.tsv.gz	/gpfs/hpc/projects/eQTLCatalogue/qtlmap/eQTL_Catalogue_r4/manuscript_sumstats/Schmiedel_2018.CD8_T-cell_naive_ge.nominal.sorted.tsv.gz.tbi	/gpfs/hpc/projects/eQTLCatalogue/qtlmap/eQTL_Catalogue_r4/manuscript_sumstats/Schmiedel_2018.CD8_T-cell_naive_ge.permuted.txt.gz
Schmiedel_2018.NK-cell_naive_ge	/gpfs/hpc/projects/eQTLCatalogue/qtlmap/eQTL_Catalogue_r4/manuscript_sumstats/Schmiedel_2018.NK-cell_naive_ge.nominal.sorted.tsv.gz	/gpfs/hpc/projects/eQTLCatalogue/qtlmap/eQTL_Catalogue_r4/manuscript_sumstats/Schmiedel_2018.NK-cell_naive_ge.nominal.sorted.tsv.gz.tbi	/gpfs/hpc/projects/eQTLCatalogue/qtlmap/eQTL_Catalogue_r4/manuscript_sumstats/Schmiedel_2018.NK-cell_naive_ge.permuted.txt.gz
Schmiedel_2018.Tfh_memory_ge	/gpfs/hpc/projects/eQTLCatalogue/qtlmap/eQTL_Catalogue_r4/manuscript_sumstats/Schmiedel_2018.Tfh_memory_ge.nominal.sorted.tsv.gz	/gpfs/hpc/projects/eQTLCatalogue/qtlmap/eQTL_Catalogue_r4/manuscript_sumstats/Schmiedel_2018.Tfh_memory_ge.nominal.sorted.tsv.gz.tbi	/gpfs/hpc/projects/eQTLCatalogue/qtlmap/eQTL_Catalogue_r4/manuscript_sumstats/Schmiedel_2018.Tfh_memory_ge.permuted.txt.gz
Schmiedel_2018.Th1-17_memory_ge	/gpfs/hpc/projects/eQTLCatalogue/qtlmap/eQTL_Catalogue_r4/manuscript_sumstats/Schmiedel_2018.Th1-17_memory_ge.nominal.sorted.tsv.gz	/gpfs/hpc/projects/eQTLCatalogue/qtlmap/eQTL_Catalogue_r4/manuscript_sumstats/Schmiedel_2018.Th1-17_memory_ge.nominal.sorted.tsv.gz.tbi	/gpfs/hpc/projects/eQTLCatalogue/qtlmap/eQTL_Catalogue_r4/manuscript_sumstats/Schmiedel_2018.Th1-17_memory_ge.permuted.txt.gz
Schmiedel_2018.Th17_memory_ge	/gpfs/hpc/projects/eQTLCatalogue/qtlmap/eQTL_Catalogue_r4/manuscript_sumstats/Schmiedel_2018.Th17_memory_ge.nominal.sorted.tsv.gz	/gpfs/hpc/projects/eQTLCatalogue/qtlmap/eQTL_Catalogue_r4/manuscript_sumstats/Schmiedel_2018.Th17_memory_ge.nominal.sorted.tsv.gz.tbi	/gpfs/hpc/projects/eQTLCatalogue/qtlmap/eQTL_Catalogue_r4/manuscript_sumstats/Schmiedel_2018.Th17_memory_ge.permuted.txt.gz
Schmiedel_2018.Th1_memory_ge	/gpfs/hpc/projects/eQTLCatalogue/qtlmap/eQTL_Catalogue_r4/manuscript_sumstats/Schmiedel_2018.Th1_memory_ge.nominal.sorted.tsv.gz	/gpfs/hpc/projects/eQTLCatalogue/qtlmap/eQTL_Catalogue_r4/manuscript_sumstats/Schmiedel_2018.Th1_memory_ge.nominal.sorted.tsv.gz.tbi	/gpfs/hpc/projects/eQTLCatalogue/qtlmap/eQTL_Catalogue_r4/manuscript_sumstats/Schmiedel_2018.Th1_memory_ge.permuted.txt.gz
Schmiedel_2018.Th2_memory_ge	/gpfs/hpc/projects/eQTLCatalogue/qtlmap/eQTL_Catalogue_r4/manuscript_sumstats/Schmiedel_2018.Th2_memory_ge.nominal.sorted.tsv.gz	/gpfs/hpc/projects/eQTLCatalogue/qtlmap/eQTL_Catalogue_r4/manuscript_sumstats/Schmiedel_2018.Th2_memory_ge.nominal.sorted.tsv.gz.tbi	/gpfs/hpc/projects/eQTLCatalogue/qtlmap/eQTL_Catalogue_r4/manuscript_sumstats/Schmiedel_2018.Th2_memory_ge.permuted.txt.gz
Schmiedel_2018.Treg_memory_ge	/gpfs/hpc/projects/eQTLCatalogue/qtlmap/eQTL_Catalogue_r4/manuscript_sumstats/Schmiedel_2018.Treg_memory_ge.nominal.sorted.tsv.gz	/gpfs/hpc/projects/eQTLCatalogue/qtlmap/eQTL_Catalogue_r4/manuscript_sumstats/Schmiedel_2018.Treg_memory_ge.nominal.sorted.tsv.gz.tbi	/gpfs/hpc/projects/eQTLCatalogue/qtlmap/eQTL_Catalogue_r4/manuscript_sumstats/Schmiedel_2018.Treg_memory_ge.permuted.txt.gz
Schmiedel_2018.Treg_naive_ge	/gpfs/hpc/projects/eQTLCatalogue/qtlmap/eQTL_Catalogue_r4/manuscript_sumstats/Schmiedel_2018.Treg_naive_ge.nominal.sorted.tsv.gz	/gpfs/hpc/projects/eQTLCatalogue/qtlmap/eQTL_Catalogue_r4/manuscript_sumstats/Schmiedel_2018.Treg_naive_ge.nominal.sorted.tsv.gz.tbi	/gpfs/hpc/projects/eQTLCatalogue/qtlmap/eQTL_Catalogue_r4/manuscript_sumstats/Schmiedel_2018.Treg_naive_ge.permuted.txt.gz
Schmiedel_2018.monocyte_CD16_naive_ge	/gpfs/hpc/projects/eQTLCatalogue/qtlmap/eQTL_Catalogue_r4/manuscript_sumstats/Schmiedel_2018.monocyte_CD16_naive_ge.nominal.sorted.tsv.gz	/gpfs/hpc/projects/eQTLCatalogue/qtlmap/eQTL_Catalogue_r4/manuscript_sumstats/Schmiedel_2018.monocyte_CD16_naive_ge.nominal.sorted.tsv.gz.tbi	/gpfs/hpc/projects/eQTLCatalogue/qtlmap/eQTL_Catalogue_r4/manuscript_sumstats/Schmiedel_2018.monocyte_CD16_naive_ge.permuted.txt.gz
Schmiedel_2018.monocyte_naive_ge	/gpfs/hpc/projects/eQTLCatalogue/qtlmap/eQTL_Catalogue_r4/manuscript_sumstats/Schmiedel_2018.monocyte_naive_ge.nominal.sorted.tsv.gz	/gpfs/hpc/projects/eQTLCatalogue/qtlmap/eQTL_Catalogue_r4/manuscript_sumstats/Schmiedel_2018.monocyte_naive_ge.nominal.sorted.tsv.gz.tbi	/gpfs/hpc/projects/eQTLCatalogue/qtlmap/eQTL_Catalogue_r4/manuscript_sumstats/Schmiedel_2018.monocyte_naive_ge.permuted.txt.gz
Schwartzentruber_2018.sensory_neuron_ge	/gpfs/hpc/projects/eQTLCatalogue/qtlmap/eQTL_Catalogue_r4/manuscript_sumstats/Schwartzentruber_2018.sensory_neuron_ge.nominal.sorted.tsv.gz	/gpfs/hpc/projects/eQTLCatalogue/qtlmap/eQTL_Catalogue_r4/manuscript_sumstats/Schwartzentruber_2018.sensory_neuron_ge.nominal.sorted.tsv.gz.tbi	/gpfs/hpc/projects/eQTLCatalogue/qtlmap/eQTL_Catalogue_r4/manuscript_sumstats/Schwartzentruber_2018.sensory_neuron_ge.permuted.txt.gz
TwinsUK.LCL_ge	/gpfs/hpc/projects/eQTLCatalogue/qtlmap/eQTL_Catalogue_r4/manuscript_sumstats/TwinsUK.LCL_ge.nominal.sorted.tsv.gz	/gpfs/hpc/projects/eQTLCatalogue/qtlmap/eQTL_Catalogue_r4/manuscript_sumstats/TwinsUK.LCL_ge.nominal.sorted.tsv.gz.tbi	/gpfs/hpc/projects/eQTLCatalogue/qtlmap/eQTL_Catalogue_r4/manuscript_sumstats/TwinsUK.LCL_ge.permuted.txt.gz
TwinsUK.blood_ge	/gpfs/hpc/projects/eQTLCatalogue/qtlmap/eQTL_Catalogue_r4/manuscript_sumstats/TwinsUK.blood_ge.nominal.sorted.tsv.gz	/gpfs/hpc/projects/eQTLCatalogue/qtlmap/eQTL_Catalogue_r4/manuscript_sumstats/TwinsUK.blood_ge.nominal.sorted.tsv.gz.tbi	/gpfs/hpc/projects/eQTLCatalogue/qtlmap/eQTL_Catalogue_r4/manuscript_sumstats/TwinsUK.blood_ge.permuted.txt.gz
TwinsUK.fat_ge	/gpfs/hpc/projects/eQTLCatalogue/qtlmap/eQTL_Catalogue_r4/manuscript_sumstats/TwinsUK.fat_ge.nominal.sorted.tsv.gz	/gpfs/hpc/projects/eQTLCatalogue/qtlmap/eQTL_Catalogue_r4/manuscript_sumstats/TwinsUK.fat_ge.nominal.sorted.tsv.gz.tbi	/gpfs/hpc/projects/eQTLCatalogue/qtlmap/eQTL_Catalogue_r4/manuscript_sumstats/TwinsUK.fat_ge.permuted.txt.gz
TwinsUK.skin_ge	/gpfs/hpc/projects/eQTLCatalogue/qtlmap/eQTL_Catalogue_r4/manuscript_sumstats/TwinsUK.skin_ge.nominal.sorted.tsv.gz	/gpfs/hpc/projects/eQTLCatalogue/qtlmap/eQTL_Catalogue_r4/manuscript_sumstats/TwinsUK.skin_ge.nominal.sorted.tsv.gz.tbi	/gpfs/hpc/projects/eQTLCatalogue/qtlmap/eQTL_Catalogue_r4/manuscript_sumstats/TwinsUK.skin_ge.permuted.txt.gz
van_de_Bunt_2015.pancreatic_islet_ge	/gpfs/hpc/projects/eQTLCatalogue/qtlmap/eQTL_Catalogue_r4/manuscript_sumstats/van_de_Bunt_2015.pancreatic_islet_ge.nominal.sorted.tsv.gz	/gpfs/hpc/projects/eQTLCatalogue/qtlmap/eQTL_Catalogue_r4/manuscript_sumstats/van_de_Bunt_2015.pancreatic_islet_ge.nominal.sorted.tsv.gz.tbi	/gpfs/hpc/projects/eQTLCatalogue/qtlmap/eQTL_Catalogue_r4/manuscript_sumstats/van_de_Bunt_2015.pancreatic_islet_ge.permuted.txt.gz