qtl_subset	qtl_ss	qtl_ss_index	qtl_credible_set_or_perm
Alasoo_2018.macrophage_IFNg+Salmonella_exon	/gpfs/hpc/projects/eQTLCatalogue/qtlmap/eQTL_Catalogue_r4/manuscript_sumstats/Alasoo_2018.macrophage_IFNg+Salmonella_exon.nominal.sorted.tsv.gz	/gpfs/hpc/projects/eQTLCatalogue/qtlmap/eQTL_Catalogue_r4/manuscript_sumstats/Alasoo_2018.macrophage_IFNg+Salmonella_exon.nominal.sorted.tsv.gz.tbi	/gpfs/hpc/projects/eQTLCatalogue/qtlmap/eQTL_Catalogue_r4/manuscript_sumstats/Alasoo_2018.macrophage_IFNg+Salmonella_exon.permuted.txt.gz
Alasoo_2018.macrophage_IFNg_exon	/gpfs/hpc/projects/eQTLCatalogue/qtlmap/eQTL_Catalogue_r4/manuscript_sumstats/Alasoo_2018.macrophage_IFNg_exon.nominal.sorted.tsv.gz	/gpfs/hpc/projects/eQTLCatalogue/qtlmap/eQTL_Catalogue_r4/manuscript_sumstats/Alasoo_2018.macrophage_IFNg_exon.nominal.sorted.tsv.gz.tbi	/gpfs/hpc/projects/eQTLCatalogue/qtlmap/eQTL_Catalogue_r4/manuscript_sumstats/Alasoo_2018.macrophage_IFNg_exon.permuted.txt.gz
Alasoo_2018.macrophage_Salmonella_exon	/gpfs/hpc/projects/eQTLCatalogue/qtlmap/eQTL_Catalogue_r4/manuscript_sumstats/Alasoo_2018.macrophage_Salmonella_exon.nominal.sorted.tsv.gz	/gpfs/hpc/projects/eQTLCatalogue/qtlmap/eQTL_Catalogue_r4/manuscript_sumstats/Alasoo_2018.macrophage_Salmonella_exon.nominal.sorted.tsv.gz.tbi	/gpfs/hpc/projects/eQTLCatalogue/qtlmap/eQTL_Catalogue_r4/manuscript_sumstats/Alasoo_2018.macrophage_Salmonella_exon.permuted.txt.gz
Alasoo_2018.macrophage_naive_exon	/gpfs/hpc/projects/eQTLCatalogue/qtlmap/eQTL_Catalogue_r4/manuscript_sumstats/Alasoo_2018.macrophage_naive_exon.nominal.sorted.tsv.gz	/gpfs/hpc/projects/eQTLCatalogue/qtlmap/eQTL_Catalogue_r4/manuscript_sumstats/Alasoo_2018.macrophage_naive_exon.nominal.sorted.tsv.gz.tbi	/gpfs/hpc/projects/eQTLCatalogue/qtlmap/eQTL_Catalogue_r4/manuscript_sumstats/Alasoo_2018.macrophage_naive_exon.permuted.txt.gz
BLUEPRINT_PE.T-cell_exon	/gpfs/hpc/projects/eQTLCatalogue/qtlmap/eQTL_Catalogue_r4/manuscript_sumstats/BLUEPRINT_PE.T-cell_exon.nominal.sorted.tsv.gz	/gpfs/hpc/projects/eQTLCatalogue/qtlmap/eQTL_Catalogue_r4/manuscript_sumstats/BLUEPRINT_PE.T-cell_exon.nominal.sorted.tsv.gz.tbi	/gpfs/hpc/projects/eQTLCatalogue/qtlmap/eQTL_Catalogue_r4/manuscript_sumstats/BLUEPRINT_PE.T-cell_exon.permuted.txt.gz
BLUEPRINT_SE.monocyte_exon	/gpfs/hpc/projects/eQTLCatalogue/qtlmap/eQTL_Catalogue_r4/manuscript_sumstats/BLUEPRINT_SE.monocyte_exon.nominal.sorted.tsv.gz	/gpfs/hpc/projects/eQTLCatalogue/qtlmap/eQTL_Catalogue_r4/manuscript_sumstats/BLUEPRINT_SE.monocyte_exon.nominal.sorted.tsv.gz.tbi	/gpfs/hpc/projects/eQTLCatalogue/qtlmap/eQTL_Catalogue_r4/manuscript_sumstats/BLUEPRINT_SE.monocyte_exon.permuted.txt.gz
BLUEPRINT_SE.neutrophil_exon	/gpfs/hpc/projects/eQTLCatalogue/qtlmap/eQTL_Catalogue_r4/manuscript_sumstats/BLUEPRINT_SE.neutrophil_exon.nominal.sorted.tsv.gz	/gpfs/hpc/projects/eQTLCatalogue/qtlmap/eQTL_Catalogue_r4/manuscript_sumstats/BLUEPRINT_SE.neutrophil_exon.nominal.sorted.tsv.gz.tbi	/gpfs/hpc/projects/eQTLCatalogue/qtlmap/eQTL_Catalogue_r4/manuscript_sumstats/BLUEPRINT_SE.neutrophil_exon.permuted.txt.gz
BrainSeq.brain_exon	/gpfs/hpc/projects/eQTLCatalogue/qtlmap/eQTL_Catalogue_r4/manuscript_sumstats/BrainSeq.brain_exon.nominal.sorted.tsv.gz	/gpfs/hpc/projects/eQTLCatalogue/qtlmap/eQTL_Catalogue_r4/manuscript_sumstats/BrainSeq.brain_exon.nominal.sorted.tsv.gz.tbi	/gpfs/hpc/projects/eQTLCatalogue/qtlmap/eQTL_Catalogue_r4/manuscript_sumstats/BrainSeq.brain_exon.permuted.txt.gz
FUSION.adipose_naive_exon	/gpfs/hpc/projects/eQTLCatalogue/qtlmap/eQTL_Catalogue_r4/manuscript_sumstats/FUSION.adipose_naive_exon.nominal.sorted.tsv.gz	/gpfs/hpc/projects/eQTLCatalogue/qtlmap/eQTL_Catalogue_r4/manuscript_sumstats/FUSION.adipose_naive_exon.nominal.sorted.tsv.gz.tbi	/gpfs/hpc/projects/eQTLCatalogue/qtlmap/eQTL_Catalogue_r4/manuscript_sumstats/FUSION.adipose_naive_exon.permuted.txt.gz
FUSION.muscle_naive_exon	/gpfs/hpc/projects/eQTLCatalogue/qtlmap/eQTL_Catalogue_r4/manuscript_sumstats/FUSION.muscle_naive_exon.nominal.sorted.tsv.gz	/gpfs/hpc/projects/eQTLCatalogue/qtlmap/eQTL_Catalogue_r4/manuscript_sumstats/FUSION.muscle_naive_exon.nominal.sorted.tsv.gz.tbi	/gpfs/hpc/projects/eQTLCatalogue/qtlmap/eQTL_Catalogue_r4/manuscript_sumstats/FUSION.muscle_naive_exon.permuted.txt.gz
GENCORD.LCL_exon	/gpfs/hpc/projects/eQTLCatalogue/qtlmap/eQTL_Catalogue_r4/manuscript_sumstats/GENCORD.LCL_exon.nominal.sorted.tsv.gz	/gpfs/hpc/projects/eQTLCatalogue/qtlmap/eQTL_Catalogue_r4/manuscript_sumstats/GENCORD.LCL_exon.nominal.sorted.tsv.gz.tbi	/gpfs/hpc/projects/eQTLCatalogue/qtlmap/eQTL_Catalogue_r4/manuscript_sumstats/GENCORD.LCL_exon.permuted.txt.gz
GENCORD.T-cell_exon	/gpfs/hpc/projects/eQTLCatalogue/qtlmap/eQTL_Catalogue_r4/manuscript_sumstats/GENCORD.T-cell_exon.nominal.sorted.tsv.gz	/gpfs/hpc/projects/eQTLCatalogue/qtlmap/eQTL_Catalogue_r4/manuscript_sumstats/GENCORD.T-cell_exon.nominal.sorted.tsv.gz.tbi	/gpfs/hpc/projects/eQTLCatalogue/qtlmap/eQTL_Catalogue_r4/manuscript_sumstats/GENCORD.T-cell_exon.permuted.txt.gz
GENCORD.fibroblast_exon	/gpfs/hpc/projects/eQTLCatalogue/qtlmap/eQTL_Catalogue_r4/manuscript_sumstats/GENCORD.fibroblast_exon.nominal.sorted.tsv.gz	/gpfs/hpc/projects/eQTLCatalogue/qtlmap/eQTL_Catalogue_r4/manuscript_sumstats/GENCORD.fibroblast_exon.nominal.sorted.tsv.gz.tbi	/gpfs/hpc/projects/eQTLCatalogue/qtlmap/eQTL_Catalogue_r4/manuscript_sumstats/GENCORD.fibroblast_exon.permuted.txt.gz
GEUVADIS.LCL_exon	/gpfs/hpc/projects/eQTLCatalogue/qtlmap/eQTL_Catalogue_r4/manuscript_sumstats/GEUVADIS.LCL_exon.nominal.sorted.tsv.gz	/gpfs/hpc/projects/eQTLCatalogue/qtlmap/eQTL_Catalogue_r4/manuscript_sumstats/GEUVADIS.LCL_exon.nominal.sorted.tsv.gz.tbi	/gpfs/hpc/projects/eQTLCatalogue/qtlmap/eQTL_Catalogue_r4/manuscript_sumstats/GEUVADIS.LCL_exon.permuted.txt.gz
GTExV8.LCL_exon	/gpfs/hpc/projects/eQTLCatalogue/qtlmap/eQTL_Catalogue_r4/manuscript_sumstats/GTExV8.LCL_exon.nominal.sorted.tsv.gz	/gpfs/hpc/projects/eQTLCatalogue/qtlmap/eQTL_Catalogue_r4/manuscript_sumstats/GTExV8.LCL_exon.nominal.sorted.tsv.gz.tbi	/gpfs/hpc/projects/eQTLCatalogue/qtlmap/eQTL_Catalogue_r4/manuscript_sumstats/GTExV8.LCL_exon.permuted.txt.gz
GTExV8.adipose_subcutaneous_exon	/gpfs/hpc/projects/eQTLCatalogue/qtlmap/eQTL_Catalogue_r4/manuscript_sumstats/GTExV8.adipose_subcutaneous_exon.nominal.sorted.tsv.gz	/gpfs/hpc/projects/eQTLCatalogue/qtlmap/eQTL_Catalogue_r4/manuscript_sumstats/GTExV8.adipose_subcutaneous_exon.nominal.sorted.tsv.gz.tbi	/gpfs/hpc/projects/eQTLCatalogue/qtlmap/eQTL_Catalogue_r4/manuscript_sumstats/GTExV8.adipose_subcutaneous_exon.permuted.txt.gz
GTExV8.adipose_visceral_exon	/gpfs/hpc/projects/eQTLCatalogue/qtlmap/eQTL_Catalogue_r4/manuscript_sumstats/GTExV8.adipose_visceral_exon.nominal.sorted.tsv.gz	/gpfs/hpc/projects/eQTLCatalogue/qtlmap/eQTL_Catalogue_r4/manuscript_sumstats/GTExV8.adipose_visceral_exon.nominal.sorted.tsv.gz.tbi	/gpfs/hpc/projects/eQTLCatalogue/qtlmap/eQTL_Catalogue_r4/manuscript_sumstats/GTExV8.adipose_visceral_exon.permuted.txt.gz
GTExV8.adrenal_gland_exon	/gpfs/hpc/projects/eQTLCatalogue/qtlmap/eQTL_Catalogue_r4/manuscript_sumstats/GTExV8.adrenal_gland_exon.nominal.sorted.tsv.gz	/gpfs/hpc/projects/eQTLCatalogue/qtlmap/eQTL_Catalogue_r4/manuscript_sumstats/GTExV8.adrenal_gland_exon.nominal.sorted.tsv.gz.tbi	/gpfs/hpc/projects/eQTLCatalogue/qtlmap/eQTL_Catalogue_r4/manuscript_sumstats/GTExV8.adrenal_gland_exon.permuted.txt.gz
GTExV8.artery_aorta_exon	/gpfs/hpc/projects/eQTLCatalogue/qtlmap/eQTL_Catalogue_r4/manuscript_sumstats/GTExV8.artery_aorta_exon.nominal.sorted.tsv.gz	/gpfs/hpc/projects/eQTLCatalogue/qtlmap/eQTL_Catalogue_r4/manuscript_sumstats/GTExV8.artery_aorta_exon.nominal.sorted.tsv.gz.tbi	/gpfs/hpc/projects/eQTLCatalogue/qtlmap/eQTL_Catalogue_r4/manuscript_sumstats/GTExV8.artery_aorta_exon.permuted.txt.gz
GTExV8.artery_coronary_exon	/gpfs/hpc/projects/eQTLCatalogue/qtlmap/eQTL_Catalogue_r4/manuscript_sumstats/GTExV8.artery_coronary_exon.nominal.sorted.tsv.gz	/gpfs/hpc/projects/eQTLCatalogue/qtlmap/eQTL_Catalogue_r4/manuscript_sumstats/GTExV8.artery_coronary_exon.nominal.sorted.tsv.gz.tbi	/gpfs/hpc/projects/eQTLCatalogue/qtlmap/eQTL_Catalogue_r4/manuscript_sumstats/GTExV8.artery_coronary_exon.permuted.txt.gz
GTExV8.artery_tibial_exon	/gpfs/hpc/projects/eQTLCatalogue/qtlmap/eQTL_Catalogue_r4/manuscript_sumstats/GTExV8.artery_tibial_exon.nominal.sorted.tsv.gz	/gpfs/hpc/projects/eQTLCatalogue/qtlmap/eQTL_Catalogue_r4/manuscript_sumstats/GTExV8.artery_tibial_exon.nominal.sorted.tsv.gz.tbi	/gpfs/hpc/projects/eQTLCatalogue/qtlmap/eQTL_Catalogue_r4/manuscript_sumstats/GTExV8.artery_tibial_exon.permuted.txt.gz
GTExV8.blood_exon	/gpfs/hpc/projects/eQTLCatalogue/qtlmap/eQTL_Catalogue_r4/manuscript_sumstats/GTExV8.blood_exon.nominal.sorted.tsv.gz	/gpfs/hpc/projects/eQTLCatalogue/qtlmap/eQTL_Catalogue_r4/manuscript_sumstats/GTExV8.blood_exon.nominal.sorted.tsv.gz.tbi	/gpfs/hpc/projects/eQTLCatalogue/qtlmap/eQTL_Catalogue_r4/manuscript_sumstats/GTExV8.blood_exon.permuted.txt.gz
GTExV8.brain_amygdala_exon	/gpfs/hpc/projects/eQTLCatalogue/qtlmap/eQTL_Catalogue_r4/manuscript_sumstats/GTExV8.brain_amygdala_exon.nominal.sorted.tsv.gz	/gpfs/hpc/projects/eQTLCatalogue/qtlmap/eQTL_Catalogue_r4/manuscript_sumstats/GTExV8.brain_amygdala_exon.nominal.sorted.tsv.gz.tbi	/gpfs/hpc/projects/eQTLCatalogue/qtlmap/eQTL_Catalogue_r4/manuscript_sumstats/GTExV8.brain_amygdala_exon.permuted.txt.gz
GTExV8.brain_anterior_cingulate_cortex_exon	/gpfs/hpc/projects/eQTLCatalogue/qtlmap/eQTL_Catalogue_r4/manuscript_sumstats/GTExV8.brain_anterior_cingulate_cortex_exon.nominal.sorted.tsv.gz	/gpfs/hpc/projects/eQTLCatalogue/qtlmap/eQTL_Catalogue_r4/manuscript_sumstats/GTExV8.brain_anterior_cingulate_cortex_exon.nominal.sorted.tsv.gz.tbi	/gpfs/hpc/projects/eQTLCatalogue/qtlmap/eQTL_Catalogue_r4/manuscript_sumstats/GTExV8.brain_anterior_cingulate_cortex_exon.permuted.txt.gz
GTExV8.brain_caudate_exon	/gpfs/hpc/projects/eQTLCatalogue/qtlmap/eQTL_Catalogue_r4/manuscript_sumstats/GTExV8.brain_caudate_exon.nominal.sorted.tsv.gz	/gpfs/hpc/projects/eQTLCatalogue/qtlmap/eQTL_Catalogue_r4/manuscript_sumstats/GTExV8.brain_caudate_exon.nominal.sorted.tsv.gz.tbi	/gpfs/hpc/projects/eQTLCatalogue/qtlmap/eQTL_Catalogue_r4/manuscript_sumstats/GTExV8.brain_caudate_exon.permuted.txt.gz
GTExV8.brain_cerebellar_hemisphere_exon	/gpfs/hpc/projects/eQTLCatalogue/qtlmap/eQTL_Catalogue_r4/manuscript_sumstats/GTExV8.brain_cerebellar_hemisphere_exon.nominal.sorted.tsv.gz	/gpfs/hpc/projects/eQTLCatalogue/qtlmap/eQTL_Catalogue_r4/manuscript_sumstats/GTExV8.brain_cerebellar_hemisphere_exon.nominal.sorted.tsv.gz.tbi	/gpfs/hpc/projects/eQTLCatalogue/qtlmap/eQTL_Catalogue_r4/manuscript_sumstats/GTExV8.brain_cerebellar_hemisphere_exon.permuted.txt.gz
GTExV8.brain_cerebellum_exon	/gpfs/hpc/projects/eQTLCatalogue/qtlmap/eQTL_Catalogue_r4/manuscript_sumstats/GTExV8.brain_cerebellum_exon.nominal.sorted.tsv.gz	/gpfs/hpc/projects/eQTLCatalogue/qtlmap/eQTL_Catalogue_r4/manuscript_sumstats/GTExV8.brain_cerebellum_exon.nominal.sorted.tsv.gz.tbi	/gpfs/hpc/projects/eQTLCatalogue/qtlmap/eQTL_Catalogue_r4/manuscript_sumstats/GTExV8.brain_cerebellum_exon.permuted.txt.gz
GTExV8.brain_cortex_exon	/gpfs/hpc/projects/eQTLCatalogue/qtlmap/eQTL_Catalogue_r4/manuscript_sumstats/GTExV8.brain_cortex_exon.nominal.sorted.tsv.gz	/gpfs/hpc/projects/eQTLCatalogue/qtlmap/eQTL_Catalogue_r4/manuscript_sumstats/GTExV8.brain_cortex_exon.nominal.sorted.tsv.gz.tbi	/gpfs/hpc/projects/eQTLCatalogue/qtlmap/eQTL_Catalogue_r4/manuscript_sumstats/GTExV8.brain_cortex_exon.permuted.txt.gz
GTExV8.brain_frontal_cortex_exon	/gpfs/hpc/projects/eQTLCatalogue/qtlmap/eQTL_Catalogue_r4/manuscript_sumstats/GTExV8.brain_frontal_cortex_exon.nominal.sorted.tsv.gz	/gpfs/hpc/projects/eQTLCatalogue/qtlmap/eQTL_Catalogue_r4/manuscript_sumstats/GTExV8.brain_frontal_cortex_exon.nominal.sorted.tsv.gz.tbi	/gpfs/hpc/projects/eQTLCatalogue/qtlmap/eQTL_Catalogue_r4/manuscript_sumstats/GTExV8.brain_frontal_cortex_exon.permuted.txt.gz
GTExV8.brain_hippocampus_exon	/gpfs/hpc/projects/eQTLCatalogue/qtlmap/eQTL_Catalogue_r4/manuscript_sumstats/GTExV8.brain_hippocampus_exon.nominal.sorted.tsv.gz	/gpfs/hpc/projects/eQTLCatalogue/qtlmap/eQTL_Catalogue_r4/manuscript_sumstats/GTExV8.brain_hippocampus_exon.nominal.sorted.tsv.gz.tbi	/gpfs/hpc/projects/eQTLCatalogue/qtlmap/eQTL_Catalogue_r4/manuscript_sumstats/GTExV8.brain_hippocampus_exon.permuted.txt.gz
GTExV8.brain_hypothalamus_exon	/gpfs/hpc/projects/eQTLCatalogue/qtlmap/eQTL_Catalogue_r4/manuscript_sumstats/GTExV8.brain_hypothalamus_exon.nominal.sorted.tsv.gz	/gpfs/hpc/projects/eQTLCatalogue/qtlmap/eQTL_Catalogue_r4/manuscript_sumstats/GTExV8.brain_hypothalamus_exon.nominal.sorted.tsv.gz.tbi	/gpfs/hpc/projects/eQTLCatalogue/qtlmap/eQTL_Catalogue_r4/manuscript_sumstats/GTExV8.brain_hypothalamus_exon.permuted.txt.gz
GTExV8.brain_nucleus_accumbens_exon	/gpfs/hpc/projects/eQTLCatalogue/qtlmap/eQTL_Catalogue_r4/manuscript_sumstats/GTExV8.brain_nucleus_accumbens_exon.nominal.sorted.tsv.gz	/gpfs/hpc/projects/eQTLCatalogue/qtlmap/eQTL_Catalogue_r4/manuscript_sumstats/GTExV8.brain_nucleus_accumbens_exon.nominal.sorted.tsv.gz.tbi	/gpfs/hpc/projects/eQTLCatalogue/qtlmap/eQTL_Catalogue_r4/manuscript_sumstats/GTExV8.brain_nucleus_accumbens_exon.permuted.txt.gz
GTExV8.brain_putamen_exon	/gpfs/hpc/projects/eQTLCatalogue/qtlmap/eQTL_Catalogue_r4/manuscript_sumstats/GTExV8.brain_putamen_exon.nominal.sorted.tsv.gz	/gpfs/hpc/projects/eQTLCatalogue/qtlmap/eQTL_Catalogue_r4/manuscript_sumstats/GTExV8.brain_putamen_exon.nominal.sorted.tsv.gz.tbi	/gpfs/hpc/projects/eQTLCatalogue/qtlmap/eQTL_Catalogue_r4/manuscript_sumstats/GTExV8.brain_putamen_exon.permuted.txt.gz
GTExV8.brain_spinal_cord_exon	/gpfs/hpc/projects/eQTLCatalogue/qtlmap/eQTL_Catalogue_r4/manuscript_sumstats/GTExV8.brain_spinal_cord_exon.nominal.sorted.tsv.gz	/gpfs/hpc/projects/eQTLCatalogue/qtlmap/eQTL_Catalogue_r4/manuscript_sumstats/GTExV8.brain_spinal_cord_exon.nominal.sorted.tsv.gz.tbi	/gpfs/hpc/projects/eQTLCatalogue/qtlmap/eQTL_Catalogue_r4/manuscript_sumstats/GTExV8.brain_spinal_cord_exon.permuted.txt.gz
GTExV8.brain_substantia_nigra_exon	/gpfs/hpc/projects/eQTLCatalogue/qtlmap/eQTL_Catalogue_r4/manuscript_sumstats/GTExV8.brain_substantia_nigra_exon.nominal.sorted.tsv.gz	/gpfs/hpc/projects/eQTLCatalogue/qtlmap/eQTL_Catalogue_r4/manuscript_sumstats/GTExV8.brain_substantia_nigra_exon.nominal.sorted.tsv.gz.tbi	/gpfs/hpc/projects/eQTLCatalogue/qtlmap/eQTL_Catalogue_r4/manuscript_sumstats/GTExV8.brain_substantia_nigra_exon.permuted.txt.gz
GTExV8.breast_exon	/gpfs/hpc/projects/eQTLCatalogue/qtlmap/eQTL_Catalogue_r4/manuscript_sumstats/GTExV8.breast_exon.nominal.sorted.tsv.gz	/gpfs/hpc/projects/eQTLCatalogue/qtlmap/eQTL_Catalogue_r4/manuscript_sumstats/GTExV8.breast_exon.nominal.sorted.tsv.gz.tbi	/gpfs/hpc/projects/eQTLCatalogue/qtlmap/eQTL_Catalogue_r4/manuscript_sumstats/GTExV8.breast_exon.permuted.txt.gz
GTExV8.colon_sigmoid_exon	/gpfs/hpc/projects/eQTLCatalogue/qtlmap/eQTL_Catalogue_r4/manuscript_sumstats/GTExV8.colon_sigmoid_exon.nominal.sorted.tsv.gz	/gpfs/hpc/projects/eQTLCatalogue/qtlmap/eQTL_Catalogue_r4/manuscript_sumstats/GTExV8.colon_sigmoid_exon.nominal.sorted.tsv.gz.tbi	/gpfs/hpc/projects/eQTLCatalogue/qtlmap/eQTL_Catalogue_r4/manuscript_sumstats/GTExV8.colon_sigmoid_exon.permuted.txt.gz
GTExV8.colon_transverse_exon	/gpfs/hpc/projects/eQTLCatalogue/qtlmap/eQTL_Catalogue_r4/manuscript_sumstats/GTExV8.colon_transverse_exon.nominal.sorted.tsv.gz	/gpfs/hpc/projects/eQTLCatalogue/qtlmap/eQTL_Catalogue_r4/manuscript_sumstats/GTExV8.colon_transverse_exon.nominal.sorted.tsv.gz.tbi	/gpfs/hpc/projects/eQTLCatalogue/qtlmap/eQTL_Catalogue_r4/manuscript_sumstats/GTExV8.colon_transverse_exon.permuted.txt.gz
GTExV8.esophagus_gej_exon	/gpfs/hpc/projects/eQTLCatalogue/qtlmap/eQTL_Catalogue_r4/manuscript_sumstats/GTExV8.esophagus_gej_exon.nominal.sorted.tsv.gz	/gpfs/hpc/projects/eQTLCatalogue/qtlmap/eQTL_Catalogue_r4/manuscript_sumstats/GTExV8.esophagus_gej_exon.nominal.sorted.tsv.gz.tbi	/gpfs/hpc/projects/eQTLCatalogue/qtlmap/eQTL_Catalogue_r4/manuscript_sumstats/GTExV8.esophagus_gej_exon.permuted.txt.gz
GTExV8.esophagus_mucosa_exon	/gpfs/hpc/projects/eQTLCatalogue/qtlmap/eQTL_Catalogue_r4/manuscript_sumstats/GTExV8.esophagus_mucosa_exon.nominal.sorted.tsv.gz	/gpfs/hpc/projects/eQTLCatalogue/qtlmap/eQTL_Catalogue_r4/manuscript_sumstats/GTExV8.esophagus_mucosa_exon.nominal.sorted.tsv.gz.tbi	/gpfs/hpc/projects/eQTLCatalogue/qtlmap/eQTL_Catalogue_r4/manuscript_sumstats/GTExV8.esophagus_mucosa_exon.permuted.txt.gz
GTExV8.esophagus_muscularis_exon	/gpfs/hpc/projects/eQTLCatalogue/qtlmap/eQTL_Catalogue_r4/manuscript_sumstats/GTExV8.esophagus_muscularis_exon.nominal.sorted.tsv.gz	/gpfs/hpc/projects/eQTLCatalogue/qtlmap/eQTL_Catalogue_r4/manuscript_sumstats/GTExV8.esophagus_muscularis_exon.nominal.sorted.tsv.gz.tbi	/gpfs/hpc/projects/eQTLCatalogue/qtlmap/eQTL_Catalogue_r4/manuscript_sumstats/GTExV8.esophagus_muscularis_exon.permuted.txt.gz
GTExV8.fibroblast_exon	/gpfs/hpc/projects/eQTLCatalogue/qtlmap/eQTL_Catalogue_r4/manuscript_sumstats/GTExV8.fibroblast_exon.nominal.sorted.tsv.gz	/gpfs/hpc/projects/eQTLCatalogue/qtlmap/eQTL_Catalogue_r4/manuscript_sumstats/GTExV8.fibroblast_exon.nominal.sorted.tsv.gz.tbi	/gpfs/hpc/projects/eQTLCatalogue/qtlmap/eQTL_Catalogue_r4/manuscript_sumstats/GTExV8.fibroblast_exon.permuted.txt.gz
GTExV8.heart_atrial_appendage_exon	/gpfs/hpc/projects/eQTLCatalogue/qtlmap/eQTL_Catalogue_r4/manuscript_sumstats/GTExV8.heart_atrial_appendage_exon.nominal.sorted.tsv.gz	/gpfs/hpc/projects/eQTLCatalogue/qtlmap/eQTL_Catalogue_r4/manuscript_sumstats/GTExV8.heart_atrial_appendage_exon.nominal.sorted.tsv.gz.tbi	/gpfs/hpc/projects/eQTLCatalogue/qtlmap/eQTL_Catalogue_r4/manuscript_sumstats/GTExV8.heart_atrial_appendage_exon.permuted.txt.gz
GTExV8.heart_left_ventricle_exon	/gpfs/hpc/projects/eQTLCatalogue/qtlmap/eQTL_Catalogue_r4/manuscript_sumstats/GTExV8.heart_left_ventricle_exon.nominal.sorted.tsv.gz	/gpfs/hpc/projects/eQTLCatalogue/qtlmap/eQTL_Catalogue_r4/manuscript_sumstats/GTExV8.heart_left_ventricle_exon.nominal.sorted.tsv.gz.tbi	/gpfs/hpc/projects/eQTLCatalogue/qtlmap/eQTL_Catalogue_r4/manuscript_sumstats/GTExV8.heart_left_ventricle_exon.permuted.txt.gz
GTExV8.kidney_cortex_exon	/gpfs/hpc/projects/eQTLCatalogue/qtlmap/eQTL_Catalogue_r4/manuscript_sumstats/GTExV8.kidney_cortex_exon.nominal.sorted.tsv.gz	/gpfs/hpc/projects/eQTLCatalogue/qtlmap/eQTL_Catalogue_r4/manuscript_sumstats/GTExV8.kidney_cortex_exon.nominal.sorted.tsv.gz.tbi	/gpfs/hpc/projects/eQTLCatalogue/qtlmap/eQTL_Catalogue_r4/manuscript_sumstats/GTExV8.kidney_cortex_exon.permuted.txt.gz
GTExV8.liver_exon	/gpfs/hpc/projects/eQTLCatalogue/qtlmap/eQTL_Catalogue_r4/manuscript_sumstats/GTExV8.liver_exon.nominal.sorted.tsv.gz	/gpfs/hpc/projects/eQTLCatalogue/qtlmap/eQTL_Catalogue_r4/manuscript_sumstats/GTExV8.liver_exon.nominal.sorted.tsv.gz.tbi	/gpfs/hpc/projects/eQTLCatalogue/qtlmap/eQTL_Catalogue_r4/manuscript_sumstats/GTExV8.liver_exon.permuted.txt.gz
GTExV8.lung_exon	/gpfs/hpc/projects/eQTLCatalogue/qtlmap/eQTL_Catalogue_r4/manuscript_sumstats/GTExV8.lung_exon.nominal.sorted.tsv.gz	/gpfs/hpc/projects/eQTLCatalogue/qtlmap/eQTL_Catalogue_r4/manuscript_sumstats/GTExV8.lung_exon.nominal.sorted.tsv.gz.tbi	/gpfs/hpc/projects/eQTLCatalogue/qtlmap/eQTL_Catalogue_r4/manuscript_sumstats/GTExV8.lung_exon.permuted.txt.gz
GTExV8.minor_salivary_gland_exon	/gpfs/hpc/projects/eQTLCatalogue/qtlmap/eQTL_Catalogue_r4/manuscript_sumstats/GTExV8.minor_salivary_gland_exon.nominal.sorted.tsv.gz	/gpfs/hpc/projects/eQTLCatalogue/qtlmap/eQTL_Catalogue_r4/manuscript_sumstats/GTExV8.minor_salivary_gland_exon.nominal.sorted.tsv.gz.tbi	/gpfs/hpc/projects/eQTLCatalogue/qtlmap/eQTL_Catalogue_r4/manuscript_sumstats/GTExV8.minor_salivary_gland_exon.permuted.txt.gz
GTExV8.muscle_exon	/gpfs/hpc/projects/eQTLCatalogue/qtlmap/eQTL_Catalogue_r4/manuscript_sumstats/GTExV8.muscle_exon.nominal.sorted.tsv.gz	/gpfs/hpc/projects/eQTLCatalogue/qtlmap/eQTL_Catalogue_r4/manuscript_sumstats/GTExV8.muscle_exon.nominal.sorted.tsv.gz.tbi	/gpfs/hpc/projects/eQTLCatalogue/qtlmap/eQTL_Catalogue_r4/manuscript_sumstats/GTExV8.muscle_exon.permuted.txt.gz
GTExV8.nerve_tibial_exon	/gpfs/hpc/projects/eQTLCatalogue/qtlmap/eQTL_Catalogue_r4/manuscript_sumstats/GTExV8.nerve_tibial_exon.nominal.sorted.tsv.gz	/gpfs/hpc/projects/eQTLCatalogue/qtlmap/eQTL_Catalogue_r4/manuscript_sumstats/GTExV8.nerve_tibial_exon.nominal.sorted.tsv.gz.tbi	/gpfs/hpc/projects/eQTLCatalogue/qtlmap/eQTL_Catalogue_r4/manuscript_sumstats/GTExV8.nerve_tibial_exon.permuted.txt.gz
GTExV8.ovary_exon	/gpfs/hpc/projects/eQTLCatalogue/qtlmap/eQTL_Catalogue_r4/manuscript_sumstats/GTExV8.ovary_exon.nominal.sorted.tsv.gz	/gpfs/hpc/projects/eQTLCatalogue/qtlmap/eQTL_Catalogue_r4/manuscript_sumstats/GTExV8.ovary_exon.nominal.sorted.tsv.gz.tbi	/gpfs/hpc/projects/eQTLCatalogue/qtlmap/eQTL_Catalogue_r4/manuscript_sumstats/GTExV8.ovary_exon.permuted.txt.gz
GTExV8.pancreas_exon	/gpfs/hpc/projects/eQTLCatalogue/qtlmap/eQTL_Catalogue_r4/manuscript_sumstats/GTExV8.pancreas_exon.nominal.sorted.tsv.gz	/gpfs/hpc/projects/eQTLCatalogue/qtlmap/eQTL_Catalogue_r4/manuscript_sumstats/GTExV8.pancreas_exon.nominal.sorted.tsv.gz.tbi	/gpfs/hpc/projects/eQTLCatalogue/qtlmap/eQTL_Catalogue_r4/manuscript_sumstats/GTExV8.pancreas_exon.permuted.txt.gz
GTExV8.pituitary_exon	/gpfs/hpc/projects/eQTLCatalogue/qtlmap/eQTL_Catalogue_r4/manuscript_sumstats/GTExV8.pituitary_exon.nominal.sorted.tsv.gz	/gpfs/hpc/projects/eQTLCatalogue/qtlmap/eQTL_Catalogue_r4/manuscript_sumstats/GTExV8.pituitary_exon.nominal.sorted.tsv.gz.tbi	/gpfs/hpc/projects/eQTLCatalogue/qtlmap/eQTL_Catalogue_r4/manuscript_sumstats/GTExV8.pituitary_exon.permuted.txt.gz
GTExV8.prostate_exon	/gpfs/hpc/projects/eQTLCatalogue/qtlmap/eQTL_Catalogue_r4/manuscript_sumstats/GTExV8.prostate_exon.nominal.sorted.tsv.gz	/gpfs/hpc/projects/eQTLCatalogue/qtlmap/eQTL_Catalogue_r4/manuscript_sumstats/GTExV8.prostate_exon.nominal.sorted.tsv.gz.tbi	/gpfs/hpc/projects/eQTLCatalogue/qtlmap/eQTL_Catalogue_r4/manuscript_sumstats/GTExV8.prostate_exon.permuted.txt.gz
GTExV8.skin_not_sun_exposed_exon	/gpfs/hpc/projects/eQTLCatalogue/qtlmap/eQTL_Catalogue_r4/manuscript_sumstats/GTExV8.skin_not_sun_exposed_exon.nominal.sorted.tsv.gz	/gpfs/hpc/projects/eQTLCatalogue/qtlmap/eQTL_Catalogue_r4/manuscript_sumstats/GTExV8.skin_not_sun_exposed_exon.nominal.sorted.tsv.gz.tbi	/gpfs/hpc/projects/eQTLCatalogue/qtlmap/eQTL_Catalogue_r4/manuscript_sumstats/GTExV8.skin_not_sun_exposed_exon.permuted.txt.gz
GTExV8.skin_sun_exposed_exon	/gpfs/hpc/projects/eQTLCatalogue/qtlmap/eQTL_Catalogue_r4/manuscript_sumstats/GTExV8.skin_sun_exposed_exon.nominal.sorted.tsv.gz	/gpfs/hpc/projects/eQTLCatalogue/qtlmap/eQTL_Catalogue_r4/manuscript_sumstats/GTExV8.skin_sun_exposed_exon.nominal.sorted.tsv.gz.tbi	/gpfs/hpc/projects/eQTLCatalogue/qtlmap/eQTL_Catalogue_r4/manuscript_sumstats/GTExV8.skin_sun_exposed_exon.permuted.txt.gz
GTExV8.small_intestine_exon	/gpfs/hpc/projects/eQTLCatalogue/qtlmap/eQTL_Catalogue_r4/manuscript_sumstats/GTExV8.small_intestine_exon.nominal.sorted.tsv.gz	/gpfs/hpc/projects/eQTLCatalogue/qtlmap/eQTL_Catalogue_r4/manuscript_sumstats/GTExV8.small_intestine_exon.nominal.sorted.tsv.gz.tbi	/gpfs/hpc/projects/eQTLCatalogue/qtlmap/eQTL_Catalogue_r4/manuscript_sumstats/GTExV8.small_intestine_exon.permuted.txt.gz
GTExV8.spleen_exon	/gpfs/hpc/projects/eQTLCatalogue/qtlmap/eQTL_Catalogue_r4/manuscript_sumstats/GTExV8.spleen_exon.nominal.sorted.tsv.gz	/gpfs/hpc/projects/eQTLCatalogue/qtlmap/eQTL_Catalogue_r4/manuscript_sumstats/GTExV8.spleen_exon.nominal.sorted.tsv.gz.tbi	/gpfs/hpc/projects/eQTLCatalogue/qtlmap/eQTL_Catalogue_r4/manuscript_sumstats/GTExV8.spleen_exon.permuted.txt.gz
GTExV8.stomach_exon	/gpfs/hpc/projects/eQTLCatalogue/qtlmap/eQTL_Catalogue_r4/manuscript_sumstats/GTExV8.stomach_exon.nominal.sorted.tsv.gz	/gpfs/hpc/projects/eQTLCatalogue/qtlmap/eQTL_Catalogue_r4/manuscript_sumstats/GTExV8.stomach_exon.nominal.sorted.tsv.gz.tbi	/gpfs/hpc/projects/eQTLCatalogue/qtlmap/eQTL_Catalogue_r4/manuscript_sumstats/GTExV8.stomach_exon.permuted.txt.gz
GTExV8.testis_exon	/gpfs/hpc/projects/eQTLCatalogue/qtlmap/eQTL_Catalogue_r4/manuscript_sumstats/GTExV8.testis_exon.nominal.sorted.tsv.gz	/gpfs/hpc/projects/eQTLCatalogue/qtlmap/eQTL_Catalogue_r4/manuscript_sumstats/GTExV8.testis_exon.nominal.sorted.tsv.gz.tbi	/gpfs/hpc/projects/eQTLCatalogue/qtlmap/eQTL_Catalogue_r4/manuscript_sumstats/GTExV8.testis_exon.permuted.txt.gz
GTExV8.thyroid_exon	/gpfs/hpc/projects/eQTLCatalogue/qtlmap/eQTL_Catalogue_r4/manuscript_sumstats/GTExV8.thyroid_exon.nominal.sorted.tsv.gz	/gpfs/hpc/projects/eQTLCatalogue/qtlmap/eQTL_Catalogue_r4/manuscript_sumstats/GTExV8.thyroid_exon.nominal.sorted.tsv.gz.tbi	/gpfs/hpc/projects/eQTLCatalogue/qtlmap/eQTL_Catalogue_r4/manuscript_sumstats/GTExV8.thyroid_exon.permuted.txt.gz
GTExV8.uterus_exon	/gpfs/hpc/projects/eQTLCatalogue/qtlmap/eQTL_Catalogue_r4/manuscript_sumstats/GTExV8.uterus_exon.nominal.sorted.tsv.gz	/gpfs/hpc/projects/eQTLCatalogue/qtlmap/eQTL_Catalogue_r4/manuscript_sumstats/GTExV8.uterus_exon.nominal.sorted.tsv.gz.tbi	/gpfs/hpc/projects/eQTLCatalogue/qtlmap/eQTL_Catalogue_r4/manuscript_sumstats/GTExV8.uterus_exon.permuted.txt.gz
GTExV8.vagina_exon	/gpfs/hpc/projects/eQTLCatalogue/qtlmap/eQTL_Catalogue_r4/manuscript_sumstats/GTExV8.vagina_exon.nominal.sorted.tsv.gz	/gpfs/hpc/projects/eQTLCatalogue/qtlmap/eQTL_Catalogue_r4/manuscript_sumstats/GTExV8.vagina_exon.nominal.sorted.tsv.gz.tbi	/gpfs/hpc/projects/eQTLCatalogue/qtlmap/eQTL_Catalogue_r4/manuscript_sumstats/GTExV8.vagina_exon.permuted.txt.gz
HipSci.iPSC_exon	/gpfs/hpc/projects/eQTLCatalogue/qtlmap/eQTL_Catalogue_r4/manuscript_sumstats/HipSci.iPSC_exon.nominal.sorted.tsv.gz	/gpfs/hpc/projects/eQTLCatalogue/qtlmap/eQTL_Catalogue_r4/manuscript_sumstats/HipSci.iPSC_exon.nominal.sorted.tsv.gz.tbi	/gpfs/hpc/projects/eQTLCatalogue/qtlmap/eQTL_Catalogue_r4/manuscript_sumstats/HipSci.iPSC_exon.permuted.txt.gz
Lepik_2017.blood_exon	/gpfs/hpc/projects/eQTLCatalogue/qtlmap/eQTL_Catalogue_r4/manuscript_sumstats/Lepik_2017.blood_exon.nominal.sorted.tsv.gz	/gpfs/hpc/projects/eQTLCatalogue/qtlmap/eQTL_Catalogue_r4/manuscript_sumstats/Lepik_2017.blood_exon.nominal.sorted.tsv.gz.tbi	/gpfs/hpc/projects/eQTLCatalogue/qtlmap/eQTL_Catalogue_r4/manuscript_sumstats/Lepik_2017.blood_exon.permuted.txt.gz
Nedelec_2016.macrophage_Listeria_exon	/gpfs/hpc/projects/eQTLCatalogue/qtlmap/eQTL_Catalogue_r4/manuscript_sumstats/Nedelec_2016.macrophage_Listeria_exon.nominal.sorted.tsv.gz	/gpfs/hpc/projects/eQTLCatalogue/qtlmap/eQTL_Catalogue_r4/manuscript_sumstats/Nedelec_2016.macrophage_Listeria_exon.nominal.sorted.tsv.gz.tbi	/gpfs/hpc/projects/eQTLCatalogue/qtlmap/eQTL_Catalogue_r4/manuscript_sumstats/Nedelec_2016.macrophage_Listeria_exon.permuted.txt.gz
Nedelec_2016.macrophage_Salmonella_exon	/gpfs/hpc/projects/eQTLCatalogue/qtlmap/eQTL_Catalogue_r4/manuscript_sumstats/Nedelec_2016.macrophage_Salmonella_exon.nominal.sorted.tsv.gz	/gpfs/hpc/projects/eQTLCatalogue/qtlmap/eQTL_Catalogue_r4/manuscript_sumstats/Nedelec_2016.macrophage_Salmonella_exon.nominal.sorted.tsv.gz.tbi	/gpfs/hpc/projects/eQTLCatalogue/qtlmap/eQTL_Catalogue_r4/manuscript_sumstats/Nedelec_2016.macrophage_Salmonella_exon.permuted.txt.gz
Nedelec_2016.macrophage_naive_exon	/gpfs/hpc/projects/eQTLCatalogue/qtlmap/eQTL_Catalogue_r4/manuscript_sumstats/Nedelec_2016.macrophage_naive_exon.nominal.sorted.tsv.gz	/gpfs/hpc/projects/eQTLCatalogue/qtlmap/eQTL_Catalogue_r4/manuscript_sumstats/Nedelec_2016.macrophage_naive_exon.nominal.sorted.tsv.gz.tbi	/gpfs/hpc/projects/eQTLCatalogue/qtlmap/eQTL_Catalogue_r4/manuscript_sumstats/Nedelec_2016.macrophage_naive_exon.permuted.txt.gz
Quach_2016.monocyte_IAV_exon	/gpfs/hpc/projects/eQTLCatalogue/qtlmap/eQTL_Catalogue_r4/manuscript_sumstats/Quach_2016.monocyte_IAV_exon.nominal.sorted.tsv.gz	/gpfs/hpc/projects/eQTLCatalogue/qtlmap/eQTL_Catalogue_r4/manuscript_sumstats/Quach_2016.monocyte_IAV_exon.nominal.sorted.tsv.gz.tbi	/gpfs/hpc/projects/eQTLCatalogue/qtlmap/eQTL_Catalogue_r4/manuscript_sumstats/Quach_2016.monocyte_IAV_exon.permuted.txt.gz
Quach_2016.monocyte_LPS_exon	/gpfs/hpc/projects/eQTLCatalogue/qtlmap/eQTL_Catalogue_r4/manuscript_sumstats/Quach_2016.monocyte_LPS_exon.nominal.sorted.tsv.gz	/gpfs/hpc/projects/eQTLCatalogue/qtlmap/eQTL_Catalogue_r4/manuscript_sumstats/Quach_2016.monocyte_LPS_exon.nominal.sorted.tsv.gz.tbi	/gpfs/hpc/projects/eQTLCatalogue/qtlmap/eQTL_Catalogue_r4/manuscript_sumstats/Quach_2016.monocyte_LPS_exon.permuted.txt.gz
Quach_2016.monocyte_Pam3CSK4_exon	/gpfs/hpc/projects/eQTLCatalogue/qtlmap/eQTL_Catalogue_r4/manuscript_sumstats/Quach_2016.monocyte_Pam3CSK4_exon.nominal.sorted.tsv.gz	/gpfs/hpc/projects/eQTLCatalogue/qtlmap/eQTL_Catalogue_r4/manuscript_sumstats/Quach_2016.monocyte_Pam3CSK4_exon.nominal.sorted.tsv.gz.tbi	/gpfs/hpc/projects/eQTLCatalogue/qtlmap/eQTL_Catalogue_r4/manuscript_sumstats/Quach_2016.monocyte_Pam3CSK4_exon.permuted.txt.gz
Quach_2016.monocyte_R848_exon	/gpfs/hpc/projects/eQTLCatalogue/qtlmap/eQTL_Catalogue_r4/manuscript_sumstats/Quach_2016.monocyte_R848_exon.nominal.sorted.tsv.gz	/gpfs/hpc/projects/eQTLCatalogue/qtlmap/eQTL_Catalogue_r4/manuscript_sumstats/Quach_2016.monocyte_R848_exon.nominal.sorted.tsv.gz.tbi	/gpfs/hpc/projects/eQTLCatalogue/qtlmap/eQTL_Catalogue_r4/manuscript_sumstats/Quach_2016.monocyte_R848_exon.permuted.txt.gz
Quach_2016.monocyte_naive_exon	/gpfs/hpc/projects/eQTLCatalogue/qtlmap/eQTL_Catalogue_r4/manuscript_sumstats/Quach_2016.monocyte_naive_exon.nominal.sorted.tsv.gz	/gpfs/hpc/projects/eQTLCatalogue/qtlmap/eQTL_Catalogue_r4/manuscript_sumstats/Quach_2016.monocyte_naive_exon.nominal.sorted.tsv.gz.tbi	/gpfs/hpc/projects/eQTLCatalogue/qtlmap/eQTL_Catalogue_r4/manuscript_sumstats/Quach_2016.monocyte_naive_exon.permuted.txt.gz
ROSMAP.brain_naive_exon	/gpfs/hpc/projects/eQTLCatalogue/qtlmap/eQTL_Catalogue_r4/manuscript_sumstats/ROSMAP.brain_naive_exon.nominal.sorted.tsv.gz	/gpfs/hpc/projects/eQTLCatalogue/qtlmap/eQTL_Catalogue_r4/manuscript_sumstats/ROSMAP.brain_naive_exon.nominal.sorted.tsv.gz.tbi	/gpfs/hpc/projects/eQTLCatalogue/qtlmap/eQTL_Catalogue_r4/manuscript_sumstats/ROSMAP.brain_naive_exon.permuted.txt.gz
Schmiedel_2018.B-cell_naive_exon	/gpfs/hpc/projects/eQTLCatalogue/qtlmap/eQTL_Catalogue_r4/manuscript_sumstats/Schmiedel_2018.B-cell_naive_exon.nominal.sorted.tsv.gz	/gpfs/hpc/projects/eQTLCatalogue/qtlmap/eQTL_Catalogue_r4/manuscript_sumstats/Schmiedel_2018.B-cell_naive_exon.nominal.sorted.tsv.gz.tbi	/gpfs/hpc/projects/eQTLCatalogue/qtlmap/eQTL_Catalogue_r4/manuscript_sumstats/Schmiedel_2018.B-cell_naive_exon.permuted.txt.gz
Schmiedel_2018.CD4_T-cell_anti-CD3-CD28_exon	/gpfs/hpc/projects/eQTLCatalogue/qtlmap/eQTL_Catalogue_r4/manuscript_sumstats/Schmiedel_2018.CD4_T-cell_anti-CD3-CD28_exon.nominal.sorted.tsv.gz	/gpfs/hpc/projects/eQTLCatalogue/qtlmap/eQTL_Catalogue_r4/manuscript_sumstats/Schmiedel_2018.CD4_T-cell_anti-CD3-CD28_exon.nominal.sorted.tsv.gz.tbi	/gpfs/hpc/projects/eQTLCatalogue/qtlmap/eQTL_Catalogue_r4/manuscript_sumstats/Schmiedel_2018.CD4_T-cell_anti-CD3-CD28_exon.permuted.txt.gz
Schmiedel_2018.CD4_T-cell_naive_exon	/gpfs/hpc/projects/eQTLCatalogue/qtlmap/eQTL_Catalogue_r4/manuscript_sumstats/Schmiedel_2018.CD4_T-cell_naive_exon.nominal.sorted.tsv.gz	/gpfs/hpc/projects/eQTLCatalogue/qtlmap/eQTL_Catalogue_r4/manuscript_sumstats/Schmiedel_2018.CD4_T-cell_naive_exon.nominal.sorted.tsv.gz.tbi	/gpfs/hpc/projects/eQTLCatalogue/qtlmap/eQTL_Catalogue_r4/manuscript_sumstats/Schmiedel_2018.CD4_T-cell_naive_exon.permuted.txt.gz
Schmiedel_2018.CD8_T-cell_anti-CD3-CD28_exon	/gpfs/hpc/projects/eQTLCatalogue/qtlmap/eQTL_Catalogue_r4/manuscript_sumstats/Schmiedel_2018.CD8_T-cell_anti-CD3-CD28_exon.nominal.sorted.tsv.gz	/gpfs/hpc/projects/eQTLCatalogue/qtlmap/eQTL_Catalogue_r4/manuscript_sumstats/Schmiedel_2018.CD8_T-cell_anti-CD3-CD28_exon.nominal.sorted.tsv.gz.tbi	/gpfs/hpc/projects/eQTLCatalogue/qtlmap/eQTL_Catalogue_r4/manuscript_sumstats/Schmiedel_2018.CD8_T-cell_anti-CD3-CD28_exon.permuted.txt.gz
Schmiedel_2018.CD8_T-cell_naive_exon	/gpfs/hpc/projects/eQTLCatalogue/qtlmap/eQTL_Catalogue_r4/manuscript_sumstats/Schmiedel_2018.CD8_T-cell_naive_exon.nominal.sorted.tsv.gz	/gpfs/hpc/projects/eQTLCatalogue/qtlmap/eQTL_Catalogue_r4/manuscript_sumstats/Schmiedel_2018.CD8_T-cell_naive_exon.nominal.sorted.tsv.gz.tbi	/gpfs/hpc/projects/eQTLCatalogue/qtlmap/eQTL_Catalogue_r4/manuscript_sumstats/Schmiedel_2018.CD8_T-cell_naive_exon.permuted.txt.gz
Schmiedel_2018.NK-cell_naive_exon	/gpfs/hpc/projects/eQTLCatalogue/qtlmap/eQTL_Catalogue_r4/manuscript_sumstats/Schmiedel_2018.NK-cell_naive_exon.nominal.sorted.tsv.gz	/gpfs/hpc/projects/eQTLCatalogue/qtlmap/eQTL_Catalogue_r4/manuscript_sumstats/Schmiedel_2018.NK-cell_naive_exon.nominal.sorted.tsv.gz.tbi	/gpfs/hpc/projects/eQTLCatalogue/qtlmap/eQTL_Catalogue_r4/manuscript_sumstats/Schmiedel_2018.NK-cell_naive_exon.permuted.txt.gz
Schmiedel_2018.Tfh_memory_exon	/gpfs/hpc/projects/eQTLCatalogue/qtlmap/eQTL_Catalogue_r4/manuscript_sumstats/Schmiedel_2018.Tfh_memory_exon.nominal.sorted.tsv.gz	/gpfs/hpc/projects/eQTLCatalogue/qtlmap/eQTL_Catalogue_r4/manuscript_sumstats/Schmiedel_2018.Tfh_memory_exon.nominal.sorted.tsv.gz.tbi	/gpfs/hpc/projects/eQTLCatalogue/qtlmap/eQTL_Catalogue_r4/manuscript_sumstats/Schmiedel_2018.Tfh_memory_exon.permuted.txt.gz
Schmiedel_2018.Th1-17_memory_exon	/gpfs/hpc/projects/eQTLCatalogue/qtlmap/eQTL_Catalogue_r4/manuscript_sumstats/Schmiedel_2018.Th1-17_memory_exon.nominal.sorted.tsv.gz	/gpfs/hpc/projects/eQTLCatalogue/qtlmap/eQTL_Catalogue_r4/manuscript_sumstats/Schmiedel_2018.Th1-17_memory_exon.nominal.sorted.tsv.gz.tbi	/gpfs/hpc/projects/eQTLCatalogue/qtlmap/eQTL_Catalogue_r4/manuscript_sumstats/Schmiedel_2018.Th1-17_memory_exon.permuted.txt.gz
Schmiedel_2018.Th17_memory_exon	/gpfs/hpc/projects/eQTLCatalogue/qtlmap/eQTL_Catalogue_r4/manuscript_sumstats/Schmiedel_2018.Th17_memory_exon.nominal.sorted.tsv.gz	/gpfs/hpc/projects/eQTLCatalogue/qtlmap/eQTL_Catalogue_r4/manuscript_sumstats/Schmiedel_2018.Th17_memory_exon.nominal.sorted.tsv.gz.tbi	/gpfs/hpc/projects/eQTLCatalogue/qtlmap/eQTL_Catalogue_r4/manuscript_sumstats/Schmiedel_2018.Th17_memory_exon.permuted.txt.gz
Schmiedel_2018.Th1_memory_exon	/gpfs/hpc/projects/eQTLCatalogue/qtlmap/eQTL_Catalogue_r4/manuscript_sumstats/Schmiedel_2018.Th1_memory_exon.nominal.sorted.tsv.gz	/gpfs/hpc/projects/eQTLCatalogue/qtlmap/eQTL_Catalogue_r4/manuscript_sumstats/Schmiedel_2018.Th1_memory_exon.nominal.sorted.tsv.gz.tbi	/gpfs/hpc/projects/eQTLCatalogue/qtlmap/eQTL_Catalogue_r4/manuscript_sumstats/Schmiedel_2018.Th1_memory_exon.permuted.txt.gz
Schmiedel_2018.Th2_memory_exon	/gpfs/hpc/projects/eQTLCatalogue/qtlmap/eQTL_Catalogue_r4/manuscript_sumstats/Schmiedel_2018.Th2_memory_exon.nominal.sorted.tsv.gz	/gpfs/hpc/projects/eQTLCatalogue/qtlmap/eQTL_Catalogue_r4/manuscript_sumstats/Schmiedel_2018.Th2_memory_exon.nominal.sorted.tsv.gz.tbi	/gpfs/hpc/projects/eQTLCatalogue/qtlmap/eQTL_Catalogue_r4/manuscript_sumstats/Schmiedel_2018.Th2_memory_exon.permuted.txt.gz
Schmiedel_2018.Treg_memory_exon	/gpfs/hpc/projects/eQTLCatalogue/qtlmap/eQTL_Catalogue_r4/manuscript_sumstats/Schmiedel_2018.Treg_memory_exon.nominal.sorted.tsv.gz	/gpfs/hpc/projects/eQTLCatalogue/qtlmap/eQTL_Catalogue_r4/manuscript_sumstats/Schmiedel_2018.Treg_memory_exon.nominal.sorted.tsv.gz.tbi	/gpfs/hpc/projects/eQTLCatalogue/qtlmap/eQTL_Catalogue_r4/manuscript_sumstats/Schmiedel_2018.Treg_memory_exon.permuted.txt.gz
Schmiedel_2018.Treg_naive_exon	/gpfs/hpc/projects/eQTLCatalogue/qtlmap/eQTL_Catalogue_r4/manuscript_sumstats/Schmiedel_2018.Treg_naive_exon.nominal.sorted.tsv.gz	/gpfs/hpc/projects/eQTLCatalogue/qtlmap/eQTL_Catalogue_r4/manuscript_sumstats/Schmiedel_2018.Treg_naive_exon.nominal.sorted.tsv.gz.tbi	/gpfs/hpc/projects/eQTLCatalogue/qtlmap/eQTL_Catalogue_r4/manuscript_sumstats/Schmiedel_2018.Treg_naive_exon.permuted.txt.gz
Schmiedel_2018.monocyte_CD16_naive_exon	/gpfs/hpc/projects/eQTLCatalogue/qtlmap/eQTL_Catalogue_r4/manuscript_sumstats/Schmiedel_2018.monocyte_CD16_naive_exon.nominal.sorted.tsv.gz	/gpfs/hpc/projects/eQTLCatalogue/qtlmap/eQTL_Catalogue_r4/manuscript_sumstats/Schmiedel_2018.monocyte_CD16_naive_exon.nominal.sorted.tsv.gz.tbi	/gpfs/hpc/projects/eQTLCatalogue/qtlmap/eQTL_Catalogue_r4/manuscript_sumstats/Schmiedel_2018.monocyte_CD16_naive_exon.permuted.txt.gz
Schmiedel_2018.monocyte_naive_exon	/gpfs/hpc/projects/eQTLCatalogue/qtlmap/eQTL_Catalogue_r4/manuscript_sumstats/Schmiedel_2018.monocyte_naive_exon.nominal.sorted.tsv.gz	/gpfs/hpc/projects/eQTLCatalogue/qtlmap/eQTL_Catalogue_r4/manuscript_sumstats/Schmiedel_2018.monocyte_naive_exon.nominal.sorted.tsv.gz.tbi	/gpfs/hpc/projects/eQTLCatalogue/qtlmap/eQTL_Catalogue_r4/manuscript_sumstats/Schmiedel_2018.monocyte_naive_exon.permuted.txt.gz
Schwartzentruber_2018.sensory_neuron_exon	/gpfs/hpc/projects/eQTLCatalogue/qtlmap/eQTL_Catalogue_r4/manuscript_sumstats/Schwartzentruber_2018.sensory_neuron_exon.nominal.sorted.tsv.gz	/gpfs/hpc/projects/eQTLCatalogue/qtlmap/eQTL_Catalogue_r4/manuscript_sumstats/Schwartzentruber_2018.sensory_neuron_exon.nominal.sorted.tsv.gz.tbi	/gpfs/hpc/projects/eQTLCatalogue/qtlmap/eQTL_Catalogue_r4/manuscript_sumstats/Schwartzentruber_2018.sensory_neuron_exon.permuted.txt.gz
TwinsUK.LCL_exon	/gpfs/hpc/projects/eQTLCatalogue/qtlmap/eQTL_Catalogue_r4/manuscript_sumstats/TwinsUK.LCL_exon.nominal.sorted.tsv.gz	/gpfs/hpc/projects/eQTLCatalogue/qtlmap/eQTL_Catalogue_r4/manuscript_sumstats/TwinsUK.LCL_exon.nominal.sorted.tsv.gz.tbi	/gpfs/hpc/projects/eQTLCatalogue/qtlmap/eQTL_Catalogue_r4/manuscript_sumstats/TwinsUK.LCL_exon.permuted.txt.gz
TwinsUK.blood_exon	/gpfs/hpc/projects/eQTLCatalogue/qtlmap/eQTL_Catalogue_r4/manuscript_sumstats/TwinsUK.blood_exon.nominal.sorted.tsv.gz	/gpfs/hpc/projects/eQTLCatalogue/qtlmap/eQTL_Catalogue_r4/manuscript_sumstats/TwinsUK.blood_exon.nominal.sorted.tsv.gz.tbi	/gpfs/hpc/projects/eQTLCatalogue/qtlmap/eQTL_Catalogue_r4/manuscript_sumstats/TwinsUK.blood_exon.permuted.txt.gz
TwinsUK.fat_exon	/gpfs/hpc/projects/eQTLCatalogue/qtlmap/eQTL_Catalogue_r4/manuscript_sumstats/TwinsUK.fat_exon.nominal.sorted.tsv.gz	/gpfs/hpc/projects/eQTLCatalogue/qtlmap/eQTL_Catalogue_r4/manuscript_sumstats/TwinsUK.fat_exon.nominal.sorted.tsv.gz.tbi	/gpfs/hpc/projects/eQTLCatalogue/qtlmap/eQTL_Catalogue_r4/manuscript_sumstats/TwinsUK.fat_exon.permuted.txt.gz
TwinsUK.skin_exon	/gpfs/hpc/projects/eQTLCatalogue/qtlmap/eQTL_Catalogue_r4/manuscript_sumstats/TwinsUK.skin_exon.nominal.sorted.tsv.gz	/gpfs/hpc/projects/eQTLCatalogue/qtlmap/eQTL_Catalogue_r4/manuscript_sumstats/TwinsUK.skin_exon.nominal.sorted.tsv.gz.tbi	/gpfs/hpc/projects/eQTLCatalogue/qtlmap/eQTL_Catalogue_r4/manuscript_sumstats/TwinsUK.skin_exon.permuted.txt.gz
van_de_Bunt_2015.pancreatic_islet_exon	/gpfs/hpc/projects/eQTLCatalogue/qtlmap/eQTL_Catalogue_r4/manuscript_sumstats/van_de_Bunt_2015.pancreatic_islet_exon.nominal.sorted.tsv.gz	/gpfs/hpc/projects/eQTLCatalogue/qtlmap/eQTL_Catalogue_r4/manuscript_sumstats/van_de_Bunt_2015.pancreatic_islet_exon.nominal.sorted.tsv.gz.tbi	/gpfs/hpc/projects/eQTLCatalogue/qtlmap/eQTL_Catalogue_r4/manuscript_sumstats/van_de_Bunt_2015.pancreatic_islet_exon.permuted.txt.gz