qtl_subset	qtl_ss	qtl_ss_index	qtl_credible_set_or_perm
Alasoo_2018.macrophage_IFNg+Salmonella_tx	/gpfs/hpc/projects/eQTLCatalogue/qtlmap/eQTL_Catalogue_r4/manuscript_sumstats/Alasoo_2018.macrophage_IFNg+Salmonella_tx.nominal.sorted.tsv.gz	/gpfs/hpc/projects/eQTLCatalogue/qtlmap/eQTL_Catalogue_r4/manuscript_sumstats/Alasoo_2018.macrophage_IFNg+Salmonella_tx.nominal.sorted.tsv.gz.tbi	/gpfs/hpc/projects/eQTLCatalogue/qtlmap/eQTL_Catalogue_r4/manuscript_sumstats/Alasoo_2018.macrophage_IFNg+Salmonella_tx.permuted.txt.gz
Alasoo_2018.macrophage_IFNg_tx	/gpfs/hpc/projects/eQTLCatalogue/qtlmap/eQTL_Catalogue_r4/manuscript_sumstats/Alasoo_2018.macrophage_IFNg_tx.nominal.sorted.tsv.gz	/gpfs/hpc/projects/eQTLCatalogue/qtlmap/eQTL_Catalogue_r4/manuscript_sumstats/Alasoo_2018.macrophage_IFNg_tx.nominal.sorted.tsv.gz.tbi	/gpfs/hpc/projects/eQTLCatalogue/qtlmap/eQTL_Catalogue_r4/manuscript_sumstats/Alasoo_2018.macrophage_IFNg_tx.permuted.txt.gz
Alasoo_2018.macrophage_Salmonella_tx	/gpfs/hpc/projects/eQTLCatalogue/qtlmap/eQTL_Catalogue_r4/manuscript_sumstats/Alasoo_2018.macrophage_Salmonella_tx.nominal.sorted.tsv.gz	/gpfs/hpc/projects/eQTLCatalogue/qtlmap/eQTL_Catalogue_r4/manuscript_sumstats/Alasoo_2018.macrophage_Salmonella_tx.nominal.sorted.tsv.gz.tbi	/gpfs/hpc/projects/eQTLCatalogue/qtlmap/eQTL_Catalogue_r4/manuscript_sumstats/Alasoo_2018.macrophage_Salmonella_tx.permuted.txt.gz
Alasoo_2018.macrophage_naive_tx	/gpfs/hpc/projects/eQTLCatalogue/qtlmap/eQTL_Catalogue_r4/manuscript_sumstats/Alasoo_2018.macrophage_naive_tx.nominal.sorted.tsv.gz	/gpfs/hpc/projects/eQTLCatalogue/qtlmap/eQTL_Catalogue_r4/manuscript_sumstats/Alasoo_2018.macrophage_naive_tx.nominal.sorted.tsv.gz.tbi	/gpfs/hpc/projects/eQTLCatalogue/qtlmap/eQTL_Catalogue_r4/manuscript_sumstats/Alasoo_2018.macrophage_naive_tx.permuted.txt.gz
BLUEPRINT_PE.T-cell_tx	/gpfs/hpc/projects/eQTLCatalogue/qtlmap/eQTL_Catalogue_r4/manuscript_sumstats/BLUEPRINT_PE.T-cell_tx.nominal.sorted.tsv.gz	/gpfs/hpc/projects/eQTLCatalogue/qtlmap/eQTL_Catalogue_r4/manuscript_sumstats/BLUEPRINT_PE.T-cell_tx.nominal.sorted.tsv.gz.tbi	/gpfs/hpc/projects/eQTLCatalogue/qtlmap/eQTL_Catalogue_r4/manuscript_sumstats/BLUEPRINT_PE.T-cell_tx.permuted.txt.gz
BLUEPRINT_SE.monocyte_tx	/gpfs/hpc/projects/eQTLCatalogue/qtlmap/eQTL_Catalogue_r4/manuscript_sumstats/BLUEPRINT_SE.monocyte_tx.nominal.sorted.tsv.gz	/gpfs/hpc/projects/eQTLCatalogue/qtlmap/eQTL_Catalogue_r4/manuscript_sumstats/BLUEPRINT_SE.monocyte_tx.nominal.sorted.tsv.gz.tbi	/gpfs/hpc/projects/eQTLCatalogue/qtlmap/eQTL_Catalogue_r4/manuscript_sumstats/BLUEPRINT_SE.monocyte_tx.permuted.txt.gz
BLUEPRINT_SE.neutrophil_tx	/gpfs/hpc/projects/eQTLCatalogue/qtlmap/eQTL_Catalogue_r4/manuscript_sumstats/BLUEPRINT_SE.neutrophil_tx.nominal.sorted.tsv.gz	/gpfs/hpc/projects/eQTLCatalogue/qtlmap/eQTL_Catalogue_r4/manuscript_sumstats/BLUEPRINT_SE.neutrophil_tx.nominal.sorted.tsv.gz.tbi	/gpfs/hpc/projects/eQTLCatalogue/qtlmap/eQTL_Catalogue_r4/manuscript_sumstats/BLUEPRINT_SE.neutrophil_tx.permuted.txt.gz
BrainSeq.brain_tx	/gpfs/hpc/projects/eQTLCatalogue/qtlmap/eQTL_Catalogue_r4/manuscript_sumstats/BrainSeq.brain_tx.nominal.sorted.tsv.gz	/gpfs/hpc/projects/eQTLCatalogue/qtlmap/eQTL_Catalogue_r4/manuscript_sumstats/BrainSeq.brain_tx.nominal.sorted.tsv.gz.tbi	/gpfs/hpc/projects/eQTLCatalogue/qtlmap/eQTL_Catalogue_r4/manuscript_sumstats/BrainSeq.brain_tx.permuted.txt.gz
FUSION.adipose_naive_tx	/gpfs/hpc/projects/eQTLCatalogue/qtlmap/eQTL_Catalogue_r4/manuscript_sumstats/FUSION.adipose_naive_tx.nominal.sorted.tsv.gz	/gpfs/hpc/projects/eQTLCatalogue/qtlmap/eQTL_Catalogue_r4/manuscript_sumstats/FUSION.adipose_naive_tx.nominal.sorted.tsv.gz.tbi	/gpfs/hpc/projects/eQTLCatalogue/qtlmap/eQTL_Catalogue_r4/manuscript_sumstats/FUSION.adipose_naive_tx.permuted.txt.gz
FUSION.muscle_naive_tx	/gpfs/hpc/projects/eQTLCatalogue/qtlmap/eQTL_Catalogue_r4/manuscript_sumstats/FUSION.muscle_naive_tx.nominal.sorted.tsv.gz	/gpfs/hpc/projects/eQTLCatalogue/qtlmap/eQTL_Catalogue_r4/manuscript_sumstats/FUSION.muscle_naive_tx.nominal.sorted.tsv.gz.tbi	/gpfs/hpc/projects/eQTLCatalogue/qtlmap/eQTL_Catalogue_r4/manuscript_sumstats/FUSION.muscle_naive_tx.permuted.txt.gz
GENCORD.LCL_tx	/gpfs/hpc/projects/eQTLCatalogue/qtlmap/eQTL_Catalogue_r4/manuscript_sumstats/GENCORD.LCL_tx.nominal.sorted.tsv.gz	/gpfs/hpc/projects/eQTLCatalogue/qtlmap/eQTL_Catalogue_r4/manuscript_sumstats/GENCORD.LCL_tx.nominal.sorted.tsv.gz.tbi	/gpfs/hpc/projects/eQTLCatalogue/qtlmap/eQTL_Catalogue_r4/manuscript_sumstats/GENCORD.LCL_tx.permuted.txt.gz
GENCORD.T-cell_tx	/gpfs/hpc/projects/eQTLCatalogue/qtlmap/eQTL_Catalogue_r4/manuscript_sumstats/GENCORD.T-cell_tx.nominal.sorted.tsv.gz	/gpfs/hpc/projects/eQTLCatalogue/qtlmap/eQTL_Catalogue_r4/manuscript_sumstats/GENCORD.T-cell_tx.nominal.sorted.tsv.gz.tbi	/gpfs/hpc/projects/eQTLCatalogue/qtlmap/eQTL_Catalogue_r4/manuscript_sumstats/GENCORD.T-cell_tx.permuted.txt.gz
GENCORD.fibroblast_tx	/gpfs/hpc/projects/eQTLCatalogue/qtlmap/eQTL_Catalogue_r4/manuscript_sumstats/GENCORD.fibroblast_tx.nominal.sorted.tsv.gz	/gpfs/hpc/projects/eQTLCatalogue/qtlmap/eQTL_Catalogue_r4/manuscript_sumstats/GENCORD.fibroblast_tx.nominal.sorted.tsv.gz.tbi	/gpfs/hpc/projects/eQTLCatalogue/qtlmap/eQTL_Catalogue_r4/manuscript_sumstats/GENCORD.fibroblast_tx.permuted.txt.gz
GEUVADIS.LCL_tx	/gpfs/hpc/projects/eQTLCatalogue/qtlmap/eQTL_Catalogue_r4/manuscript_sumstats/GEUVADIS.LCL_tx.nominal.sorted.tsv.gz	/gpfs/hpc/projects/eQTLCatalogue/qtlmap/eQTL_Catalogue_r4/manuscript_sumstats/GEUVADIS.LCL_tx.nominal.sorted.tsv.gz.tbi	/gpfs/hpc/projects/eQTLCatalogue/qtlmap/eQTL_Catalogue_r4/manuscript_sumstats/GEUVADIS.LCL_tx.permuted.txt.gz
GTExV8.LCL_tx	/gpfs/hpc/projects/eQTLCatalogue/qtlmap/eQTL_Catalogue_r4/manuscript_sumstats/GTExV8.LCL_tx.nominal.sorted.tsv.gz	/gpfs/hpc/projects/eQTLCatalogue/qtlmap/eQTL_Catalogue_r4/manuscript_sumstats/GTExV8.LCL_tx.nominal.sorted.tsv.gz.tbi	/gpfs/hpc/projects/eQTLCatalogue/qtlmap/eQTL_Catalogue_r4/manuscript_sumstats/GTExV8.LCL_tx.permuted.txt.gz
GTExV8.adipose_subcutaneous_tx	/gpfs/hpc/projects/eQTLCatalogue/qtlmap/eQTL_Catalogue_r4/manuscript_sumstats/GTExV8.adipose_subcutaneous_tx.nominal.sorted.tsv.gz	/gpfs/hpc/projects/eQTLCatalogue/qtlmap/eQTL_Catalogue_r4/manuscript_sumstats/GTExV8.adipose_subcutaneous_tx.nominal.sorted.tsv.gz.tbi	/gpfs/hpc/projects/eQTLCatalogue/qtlmap/eQTL_Catalogue_r4/manuscript_sumstats/GTExV8.adipose_subcutaneous_tx.permuted.txt.gz
GTExV8.adipose_visceral_tx	/gpfs/hpc/projects/eQTLCatalogue/qtlmap/eQTL_Catalogue_r4/manuscript_sumstats/GTExV8.adipose_visceral_tx.nominal.sorted.tsv.gz	/gpfs/hpc/projects/eQTLCatalogue/qtlmap/eQTL_Catalogue_r4/manuscript_sumstats/GTExV8.adipose_visceral_tx.nominal.sorted.tsv.gz.tbi	/gpfs/hpc/projects/eQTLCatalogue/qtlmap/eQTL_Catalogue_r4/manuscript_sumstats/GTExV8.adipose_visceral_tx.permuted.txt.gz
GTExV8.adrenal_gland_tx	/gpfs/hpc/projects/eQTLCatalogue/qtlmap/eQTL_Catalogue_r4/manuscript_sumstats/GTExV8.adrenal_gland_tx.nominal.sorted.tsv.gz	/gpfs/hpc/projects/eQTLCatalogue/qtlmap/eQTL_Catalogue_r4/manuscript_sumstats/GTExV8.adrenal_gland_tx.nominal.sorted.tsv.gz.tbi	/gpfs/hpc/projects/eQTLCatalogue/qtlmap/eQTL_Catalogue_r4/manuscript_sumstats/GTExV8.adrenal_gland_tx.permuted.txt.gz
GTExV8.artery_aorta_tx	/gpfs/hpc/projects/eQTLCatalogue/qtlmap/eQTL_Catalogue_r4/manuscript_sumstats/GTExV8.artery_aorta_tx.nominal.sorted.tsv.gz	/gpfs/hpc/projects/eQTLCatalogue/qtlmap/eQTL_Catalogue_r4/manuscript_sumstats/GTExV8.artery_aorta_tx.nominal.sorted.tsv.gz.tbi	/gpfs/hpc/projects/eQTLCatalogue/qtlmap/eQTL_Catalogue_r4/manuscript_sumstats/GTExV8.artery_aorta_tx.permuted.txt.gz
GTExV8.artery_coronary_tx	/gpfs/hpc/projects/eQTLCatalogue/qtlmap/eQTL_Catalogue_r4/manuscript_sumstats/GTExV8.artery_coronary_tx.nominal.sorted.tsv.gz	/gpfs/hpc/projects/eQTLCatalogue/qtlmap/eQTL_Catalogue_r4/manuscript_sumstats/GTExV8.artery_coronary_tx.nominal.sorted.tsv.gz.tbi	/gpfs/hpc/projects/eQTLCatalogue/qtlmap/eQTL_Catalogue_r4/manuscript_sumstats/GTExV8.artery_coronary_tx.permuted.txt.gz
GTExV8.artery_tibial_tx	/gpfs/hpc/projects/eQTLCatalogue/qtlmap/eQTL_Catalogue_r4/manuscript_sumstats/GTExV8.artery_tibial_tx.nominal.sorted.tsv.gz	/gpfs/hpc/projects/eQTLCatalogue/qtlmap/eQTL_Catalogue_r4/manuscript_sumstats/GTExV8.artery_tibial_tx.nominal.sorted.tsv.gz.tbi	/gpfs/hpc/projects/eQTLCatalogue/qtlmap/eQTL_Catalogue_r4/manuscript_sumstats/GTExV8.artery_tibial_tx.permuted.txt.gz
GTExV8.blood_tx	/gpfs/hpc/projects/eQTLCatalogue/qtlmap/eQTL_Catalogue_r4/manuscript_sumstats/GTExV8.blood_tx.nominal.sorted.tsv.gz	/gpfs/hpc/projects/eQTLCatalogue/qtlmap/eQTL_Catalogue_r4/manuscript_sumstats/GTExV8.blood_tx.nominal.sorted.tsv.gz.tbi	/gpfs/hpc/projects/eQTLCatalogue/qtlmap/eQTL_Catalogue_r4/manuscript_sumstats/GTExV8.blood_tx.permuted.txt.gz
GTExV8.brain_amygdala_tx	/gpfs/hpc/projects/eQTLCatalogue/qtlmap/eQTL_Catalogue_r4/manuscript_sumstats/GTExV8.brain_amygdala_tx.nominal.sorted.tsv.gz	/gpfs/hpc/projects/eQTLCatalogue/qtlmap/eQTL_Catalogue_r4/manuscript_sumstats/GTExV8.brain_amygdala_tx.nominal.sorted.tsv.gz.tbi	/gpfs/hpc/projects/eQTLCatalogue/qtlmap/eQTL_Catalogue_r4/manuscript_sumstats/GTExV8.brain_amygdala_tx.permuted.txt.gz
GTExV8.brain_anterior_cingulate_cortex_tx	/gpfs/hpc/projects/eQTLCatalogue/qtlmap/eQTL_Catalogue_r4/manuscript_sumstats/GTExV8.brain_anterior_cingulate_cortex_tx.nominal.sorted.tsv.gz	/gpfs/hpc/projects/eQTLCatalogue/qtlmap/eQTL_Catalogue_r4/manuscript_sumstats/GTExV8.brain_anterior_cingulate_cortex_tx.nominal.sorted.tsv.gz.tbi	/gpfs/hpc/projects/eQTLCatalogue/qtlmap/eQTL_Catalogue_r4/manuscript_sumstats/GTExV8.brain_anterior_cingulate_cortex_tx.permuted.txt.gz
GTExV8.brain_caudate_tx	/gpfs/hpc/projects/eQTLCatalogue/qtlmap/eQTL_Catalogue_r4/manuscript_sumstats/GTExV8.brain_caudate_tx.nominal.sorted.tsv.gz	/gpfs/hpc/projects/eQTLCatalogue/qtlmap/eQTL_Catalogue_r4/manuscript_sumstats/GTExV8.brain_caudate_tx.nominal.sorted.tsv.gz.tbi	/gpfs/hpc/projects/eQTLCatalogue/qtlmap/eQTL_Catalogue_r4/manuscript_sumstats/GTExV8.brain_caudate_tx.permuted.txt.gz
GTExV8.brain_cerebellar_hemisphere_tx	/gpfs/hpc/projects/eQTLCatalogue/qtlmap/eQTL_Catalogue_r4/manuscript_sumstats/GTExV8.brain_cerebellar_hemisphere_tx.nominal.sorted.tsv.gz	/gpfs/hpc/projects/eQTLCatalogue/qtlmap/eQTL_Catalogue_r4/manuscript_sumstats/GTExV8.brain_cerebellar_hemisphere_tx.nominal.sorted.tsv.gz.tbi	/gpfs/hpc/projects/eQTLCatalogue/qtlmap/eQTL_Catalogue_r4/manuscript_sumstats/GTExV8.brain_cerebellar_hemisphere_tx.permuted.txt.gz
GTExV8.brain_cerebellum_tx	/gpfs/hpc/projects/eQTLCatalogue/qtlmap/eQTL_Catalogue_r4/manuscript_sumstats/GTExV8.brain_cerebellum_tx.nominal.sorted.tsv.gz	/gpfs/hpc/projects/eQTLCatalogue/qtlmap/eQTL_Catalogue_r4/manuscript_sumstats/GTExV8.brain_cerebellum_tx.nominal.sorted.tsv.gz.tbi	/gpfs/hpc/projects/eQTLCatalogue/qtlmap/eQTL_Catalogue_r4/manuscript_sumstats/GTExV8.brain_cerebellum_tx.permuted.txt.gz
GTExV8.brain_cortex_tx	/gpfs/hpc/projects/eQTLCatalogue/qtlmap/eQTL_Catalogue_r4/manuscript_sumstats/GTExV8.brain_cortex_tx.nominal.sorted.tsv.gz	/gpfs/hpc/projects/eQTLCatalogue/qtlmap/eQTL_Catalogue_r4/manuscript_sumstats/GTExV8.brain_cortex_tx.nominal.sorted.tsv.gz.tbi	/gpfs/hpc/projects/eQTLCatalogue/qtlmap/eQTL_Catalogue_r4/manuscript_sumstats/GTExV8.brain_cortex_tx.permuted.txt.gz
GTExV8.brain_frontal_cortex_tx	/gpfs/hpc/projects/eQTLCatalogue/qtlmap/eQTL_Catalogue_r4/manuscript_sumstats/GTExV8.brain_frontal_cortex_tx.nominal.sorted.tsv.gz	/gpfs/hpc/projects/eQTLCatalogue/qtlmap/eQTL_Catalogue_r4/manuscript_sumstats/GTExV8.brain_frontal_cortex_tx.nominal.sorted.tsv.gz.tbi	/gpfs/hpc/projects/eQTLCatalogue/qtlmap/eQTL_Catalogue_r4/manuscript_sumstats/GTExV8.brain_frontal_cortex_tx.permuted.txt.gz
GTExV8.brain_hippocampus_tx	/gpfs/hpc/projects/eQTLCatalogue/qtlmap/eQTL_Catalogue_r4/manuscript_sumstats/GTExV8.brain_hippocampus_tx.nominal.sorted.tsv.gz	/gpfs/hpc/projects/eQTLCatalogue/qtlmap/eQTL_Catalogue_r4/manuscript_sumstats/GTExV8.brain_hippocampus_tx.nominal.sorted.tsv.gz.tbi	/gpfs/hpc/projects/eQTLCatalogue/qtlmap/eQTL_Catalogue_r4/manuscript_sumstats/GTExV8.brain_hippocampus_tx.permuted.txt.gz
GTExV8.brain_hypothalamus_tx	/gpfs/hpc/projects/eQTLCatalogue/qtlmap/eQTL_Catalogue_r4/manuscript_sumstats/GTExV8.brain_hypothalamus_tx.nominal.sorted.tsv.gz	/gpfs/hpc/projects/eQTLCatalogue/qtlmap/eQTL_Catalogue_r4/manuscript_sumstats/GTExV8.brain_hypothalamus_tx.nominal.sorted.tsv.gz.tbi	/gpfs/hpc/projects/eQTLCatalogue/qtlmap/eQTL_Catalogue_r4/manuscript_sumstats/GTExV8.brain_hypothalamus_tx.permuted.txt.gz
GTExV8.brain_nucleus_accumbens_tx	/gpfs/hpc/projects/eQTLCatalogue/qtlmap/eQTL_Catalogue_r4/manuscript_sumstats/GTExV8.brain_nucleus_accumbens_tx.nominal.sorted.tsv.gz	/gpfs/hpc/projects/eQTLCatalogue/qtlmap/eQTL_Catalogue_r4/manuscript_sumstats/GTExV8.brain_nucleus_accumbens_tx.nominal.sorted.tsv.gz.tbi	/gpfs/hpc/projects/eQTLCatalogue/qtlmap/eQTL_Catalogue_r4/manuscript_sumstats/GTExV8.brain_nucleus_accumbens_tx.permuted.txt.gz
GTExV8.brain_putamen_tx	/gpfs/hpc/projects/eQTLCatalogue/qtlmap/eQTL_Catalogue_r4/manuscript_sumstats/GTExV8.brain_putamen_tx.nominal.sorted.tsv.gz	/gpfs/hpc/projects/eQTLCatalogue/qtlmap/eQTL_Catalogue_r4/manuscript_sumstats/GTExV8.brain_putamen_tx.nominal.sorted.tsv.gz.tbi	/gpfs/hpc/projects/eQTLCatalogue/qtlmap/eQTL_Catalogue_r4/manuscript_sumstats/GTExV8.brain_putamen_tx.permuted.txt.gz
GTExV8.brain_spinal_cord_tx	/gpfs/hpc/projects/eQTLCatalogue/qtlmap/eQTL_Catalogue_r4/manuscript_sumstats/GTExV8.brain_spinal_cord_tx.nominal.sorted.tsv.gz	/gpfs/hpc/projects/eQTLCatalogue/qtlmap/eQTL_Catalogue_r4/manuscript_sumstats/GTExV8.brain_spinal_cord_tx.nominal.sorted.tsv.gz.tbi	/gpfs/hpc/projects/eQTLCatalogue/qtlmap/eQTL_Catalogue_r4/manuscript_sumstats/GTExV8.brain_spinal_cord_tx.permuted.txt.gz
GTExV8.brain_substantia_nigra_tx	/gpfs/hpc/projects/eQTLCatalogue/qtlmap/eQTL_Catalogue_r4/manuscript_sumstats/GTExV8.brain_substantia_nigra_tx.nominal.sorted.tsv.gz	/gpfs/hpc/projects/eQTLCatalogue/qtlmap/eQTL_Catalogue_r4/manuscript_sumstats/GTExV8.brain_substantia_nigra_tx.nominal.sorted.tsv.gz.tbi	/gpfs/hpc/projects/eQTLCatalogue/qtlmap/eQTL_Catalogue_r4/manuscript_sumstats/GTExV8.brain_substantia_nigra_tx.permuted.txt.gz
GTExV8.breast_tx	/gpfs/hpc/projects/eQTLCatalogue/qtlmap/eQTL_Catalogue_r4/manuscript_sumstats/GTExV8.breast_tx.nominal.sorted.tsv.gz	/gpfs/hpc/projects/eQTLCatalogue/qtlmap/eQTL_Catalogue_r4/manuscript_sumstats/GTExV8.breast_tx.nominal.sorted.tsv.gz.tbi	/gpfs/hpc/projects/eQTLCatalogue/qtlmap/eQTL_Catalogue_r4/manuscript_sumstats/GTExV8.breast_tx.permuted.txt.gz
GTExV8.colon_sigmoid_tx	/gpfs/hpc/projects/eQTLCatalogue/qtlmap/eQTL_Catalogue_r4/manuscript_sumstats/GTExV8.colon_sigmoid_tx.nominal.sorted.tsv.gz	/gpfs/hpc/projects/eQTLCatalogue/qtlmap/eQTL_Catalogue_r4/manuscript_sumstats/GTExV8.colon_sigmoid_tx.nominal.sorted.tsv.gz.tbi	/gpfs/hpc/projects/eQTLCatalogue/qtlmap/eQTL_Catalogue_r4/manuscript_sumstats/GTExV8.colon_sigmoid_tx.permuted.txt.gz
GTExV8.colon_transverse_tx	/gpfs/hpc/projects/eQTLCatalogue/qtlmap/eQTL_Catalogue_r4/manuscript_sumstats/GTExV8.colon_transverse_tx.nominal.sorted.tsv.gz	/gpfs/hpc/projects/eQTLCatalogue/qtlmap/eQTL_Catalogue_r4/manuscript_sumstats/GTExV8.colon_transverse_tx.nominal.sorted.tsv.gz.tbi	/gpfs/hpc/projects/eQTLCatalogue/qtlmap/eQTL_Catalogue_r4/manuscript_sumstats/GTExV8.colon_transverse_tx.permuted.txt.gz
GTExV8.esophagus_gej_tx	/gpfs/hpc/projects/eQTLCatalogue/qtlmap/eQTL_Catalogue_r4/manuscript_sumstats/GTExV8.esophagus_gej_tx.nominal.sorted.tsv.gz	/gpfs/hpc/projects/eQTLCatalogue/qtlmap/eQTL_Catalogue_r4/manuscript_sumstats/GTExV8.esophagus_gej_tx.nominal.sorted.tsv.gz.tbi	/gpfs/hpc/projects/eQTLCatalogue/qtlmap/eQTL_Catalogue_r4/manuscript_sumstats/GTExV8.esophagus_gej_tx.permuted.txt.gz
GTExV8.esophagus_mucosa_tx	/gpfs/hpc/projects/eQTLCatalogue/qtlmap/eQTL_Catalogue_r4/manuscript_sumstats/GTExV8.esophagus_mucosa_tx.nominal.sorted.tsv.gz	/gpfs/hpc/projects/eQTLCatalogue/qtlmap/eQTL_Catalogue_r4/manuscript_sumstats/GTExV8.esophagus_mucosa_tx.nominal.sorted.tsv.gz.tbi	/gpfs/hpc/projects/eQTLCatalogue/qtlmap/eQTL_Catalogue_r4/manuscript_sumstats/GTExV8.esophagus_mucosa_tx.permuted.txt.gz
GTExV8.esophagus_muscularis_tx	/gpfs/hpc/projects/eQTLCatalogue/qtlmap/eQTL_Catalogue_r4/manuscript_sumstats/GTExV8.esophagus_muscularis_tx.nominal.sorted.tsv.gz	/gpfs/hpc/projects/eQTLCatalogue/qtlmap/eQTL_Catalogue_r4/manuscript_sumstats/GTExV8.esophagus_muscularis_tx.nominal.sorted.tsv.gz.tbi	/gpfs/hpc/projects/eQTLCatalogue/qtlmap/eQTL_Catalogue_r4/manuscript_sumstats/GTExV8.esophagus_muscularis_tx.permuted.txt.gz
GTExV8.fibroblast_tx	/gpfs/hpc/projects/eQTLCatalogue/qtlmap/eQTL_Catalogue_r4/manuscript_sumstats/GTExV8.fibroblast_tx.nominal.sorted.tsv.gz	/gpfs/hpc/projects/eQTLCatalogue/qtlmap/eQTL_Catalogue_r4/manuscript_sumstats/GTExV8.fibroblast_tx.nominal.sorted.tsv.gz.tbi	/gpfs/hpc/projects/eQTLCatalogue/qtlmap/eQTL_Catalogue_r4/manuscript_sumstats/GTExV8.fibroblast_tx.permuted.txt.gz
GTExV8.heart_atrial_appendage_tx	/gpfs/hpc/projects/eQTLCatalogue/qtlmap/eQTL_Catalogue_r4/manuscript_sumstats/GTExV8.heart_atrial_appendage_tx.nominal.sorted.tsv.gz	/gpfs/hpc/projects/eQTLCatalogue/qtlmap/eQTL_Catalogue_r4/manuscript_sumstats/GTExV8.heart_atrial_appendage_tx.nominal.sorted.tsv.gz.tbi	/gpfs/hpc/projects/eQTLCatalogue/qtlmap/eQTL_Catalogue_r4/manuscript_sumstats/GTExV8.heart_atrial_appendage_tx.permuted.txt.gz
GTExV8.heart_left_ventricle_tx	/gpfs/hpc/projects/eQTLCatalogue/qtlmap/eQTL_Catalogue_r4/manuscript_sumstats/GTExV8.heart_left_ventricle_tx.nominal.sorted.tsv.gz	/gpfs/hpc/projects/eQTLCatalogue/qtlmap/eQTL_Catalogue_r4/manuscript_sumstats/GTExV8.heart_left_ventricle_tx.nominal.sorted.tsv.gz.tbi	/gpfs/hpc/projects/eQTLCatalogue/qtlmap/eQTL_Catalogue_r4/manuscript_sumstats/GTExV8.heart_left_ventricle_tx.permuted.txt.gz
GTExV8.kidney_cortex_tx	/gpfs/hpc/projects/eQTLCatalogue/qtlmap/eQTL_Catalogue_r4/manuscript_sumstats/GTExV8.kidney_cortex_tx.nominal.sorted.tsv.gz	/gpfs/hpc/projects/eQTLCatalogue/qtlmap/eQTL_Catalogue_r4/manuscript_sumstats/GTExV8.kidney_cortex_tx.nominal.sorted.tsv.gz.tbi	/gpfs/hpc/projects/eQTLCatalogue/qtlmap/eQTL_Catalogue_r4/manuscript_sumstats/GTExV8.kidney_cortex_tx.permuted.txt.gz
GTExV8.liver_tx	/gpfs/hpc/projects/eQTLCatalogue/qtlmap/eQTL_Catalogue_r4/manuscript_sumstats/GTExV8.liver_tx.nominal.sorted.tsv.gz	/gpfs/hpc/projects/eQTLCatalogue/qtlmap/eQTL_Catalogue_r4/manuscript_sumstats/GTExV8.liver_tx.nominal.sorted.tsv.gz.tbi	/gpfs/hpc/projects/eQTLCatalogue/qtlmap/eQTL_Catalogue_r4/manuscript_sumstats/GTExV8.liver_tx.permuted.txt.gz
GTExV8.lung_tx	/gpfs/hpc/projects/eQTLCatalogue/qtlmap/eQTL_Catalogue_r4/manuscript_sumstats/GTExV8.lung_tx.nominal.sorted.tsv.gz	/gpfs/hpc/projects/eQTLCatalogue/qtlmap/eQTL_Catalogue_r4/manuscript_sumstats/GTExV8.lung_tx.nominal.sorted.tsv.gz.tbi	/gpfs/hpc/projects/eQTLCatalogue/qtlmap/eQTL_Catalogue_r4/manuscript_sumstats/GTExV8.lung_tx.permuted.txt.gz
GTExV8.minor_salivary_gland_tx	/gpfs/hpc/projects/eQTLCatalogue/qtlmap/eQTL_Catalogue_r4/manuscript_sumstats/GTExV8.minor_salivary_gland_tx.nominal.sorted.tsv.gz	/gpfs/hpc/projects/eQTLCatalogue/qtlmap/eQTL_Catalogue_r4/manuscript_sumstats/GTExV8.minor_salivary_gland_tx.nominal.sorted.tsv.gz.tbi	/gpfs/hpc/projects/eQTLCatalogue/qtlmap/eQTL_Catalogue_r4/manuscript_sumstats/GTExV8.minor_salivary_gland_tx.permuted.txt.gz
GTExV8.muscle_tx	/gpfs/hpc/projects/eQTLCatalogue/qtlmap/eQTL_Catalogue_r4/manuscript_sumstats/GTExV8.muscle_tx.nominal.sorted.tsv.gz	/gpfs/hpc/projects/eQTLCatalogue/qtlmap/eQTL_Catalogue_r4/manuscript_sumstats/GTExV8.muscle_tx.nominal.sorted.tsv.gz.tbi	/gpfs/hpc/projects/eQTLCatalogue/qtlmap/eQTL_Catalogue_r4/manuscript_sumstats/GTExV8.muscle_tx.permuted.txt.gz
GTExV8.nerve_tibial_tx	/gpfs/hpc/projects/eQTLCatalogue/qtlmap/eQTL_Catalogue_r4/manuscript_sumstats/GTExV8.nerve_tibial_tx.nominal.sorted.tsv.gz	/gpfs/hpc/projects/eQTLCatalogue/qtlmap/eQTL_Catalogue_r4/manuscript_sumstats/GTExV8.nerve_tibial_tx.nominal.sorted.tsv.gz.tbi	/gpfs/hpc/projects/eQTLCatalogue/qtlmap/eQTL_Catalogue_r4/manuscript_sumstats/GTExV8.nerve_tibial_tx.permuted.txt.gz
GTExV8.ovary_tx	/gpfs/hpc/projects/eQTLCatalogue/qtlmap/eQTL_Catalogue_r4/manuscript_sumstats/GTExV8.ovary_tx.nominal.sorted.tsv.gz	/gpfs/hpc/projects/eQTLCatalogue/qtlmap/eQTL_Catalogue_r4/manuscript_sumstats/GTExV8.ovary_tx.nominal.sorted.tsv.gz.tbi	/gpfs/hpc/projects/eQTLCatalogue/qtlmap/eQTL_Catalogue_r4/manuscript_sumstats/GTExV8.ovary_tx.permuted.txt.gz
GTExV8.pancreas_tx	/gpfs/hpc/projects/eQTLCatalogue/qtlmap/eQTL_Catalogue_r4/manuscript_sumstats/GTExV8.pancreas_tx.nominal.sorted.tsv.gz	/gpfs/hpc/projects/eQTLCatalogue/qtlmap/eQTL_Catalogue_r4/manuscript_sumstats/GTExV8.pancreas_tx.nominal.sorted.tsv.gz.tbi	/gpfs/hpc/projects/eQTLCatalogue/qtlmap/eQTL_Catalogue_r4/manuscript_sumstats/GTExV8.pancreas_tx.permuted.txt.gz
GTExV8.pituitary_tx	/gpfs/hpc/projects/eQTLCatalogue/qtlmap/eQTL_Catalogue_r4/manuscript_sumstats/GTExV8.pituitary_tx.nominal.sorted.tsv.gz	/gpfs/hpc/projects/eQTLCatalogue/qtlmap/eQTL_Catalogue_r4/manuscript_sumstats/GTExV8.pituitary_tx.nominal.sorted.tsv.gz.tbi	/gpfs/hpc/projects/eQTLCatalogue/qtlmap/eQTL_Catalogue_r4/manuscript_sumstats/GTExV8.pituitary_tx.permuted.txt.gz
GTExV8.prostate_tx	/gpfs/hpc/projects/eQTLCatalogue/qtlmap/eQTL_Catalogue_r4/manuscript_sumstats/GTExV8.prostate_tx.nominal.sorted.tsv.gz	/gpfs/hpc/projects/eQTLCatalogue/qtlmap/eQTL_Catalogue_r4/manuscript_sumstats/GTExV8.prostate_tx.nominal.sorted.tsv.gz.tbi	/gpfs/hpc/projects/eQTLCatalogue/qtlmap/eQTL_Catalogue_r4/manuscript_sumstats/GTExV8.prostate_tx.permuted.txt.gz
GTExV8.skin_not_sun_exposed_tx	/gpfs/hpc/projects/eQTLCatalogue/qtlmap/eQTL_Catalogue_r4/manuscript_sumstats/GTExV8.skin_not_sun_exposed_tx.nominal.sorted.tsv.gz	/gpfs/hpc/projects/eQTLCatalogue/qtlmap/eQTL_Catalogue_r4/manuscript_sumstats/GTExV8.skin_not_sun_exposed_tx.nominal.sorted.tsv.gz.tbi	/gpfs/hpc/projects/eQTLCatalogue/qtlmap/eQTL_Catalogue_r4/manuscript_sumstats/GTExV8.skin_not_sun_exposed_tx.permuted.txt.gz
GTExV8.skin_sun_exposed_tx	/gpfs/hpc/projects/eQTLCatalogue/qtlmap/eQTL_Catalogue_r4/manuscript_sumstats/GTExV8.skin_sun_exposed_tx.nominal.sorted.tsv.gz	/gpfs/hpc/projects/eQTLCatalogue/qtlmap/eQTL_Catalogue_r4/manuscript_sumstats/GTExV8.skin_sun_exposed_tx.nominal.sorted.tsv.gz.tbi	/gpfs/hpc/projects/eQTLCatalogue/qtlmap/eQTL_Catalogue_r4/manuscript_sumstats/GTExV8.skin_sun_exposed_tx.permuted.txt.gz
GTExV8.small_intestine_tx	/gpfs/hpc/projects/eQTLCatalogue/qtlmap/eQTL_Catalogue_r4/manuscript_sumstats/GTExV8.small_intestine_tx.nominal.sorted.tsv.gz	/gpfs/hpc/projects/eQTLCatalogue/qtlmap/eQTL_Catalogue_r4/manuscript_sumstats/GTExV8.small_intestine_tx.nominal.sorted.tsv.gz.tbi	/gpfs/hpc/projects/eQTLCatalogue/qtlmap/eQTL_Catalogue_r4/manuscript_sumstats/GTExV8.small_intestine_tx.permuted.txt.gz
GTExV8.spleen_tx	/gpfs/hpc/projects/eQTLCatalogue/qtlmap/eQTL_Catalogue_r4/manuscript_sumstats/GTExV8.spleen_tx.nominal.sorted.tsv.gz	/gpfs/hpc/projects/eQTLCatalogue/qtlmap/eQTL_Catalogue_r4/manuscript_sumstats/GTExV8.spleen_tx.nominal.sorted.tsv.gz.tbi	/gpfs/hpc/projects/eQTLCatalogue/qtlmap/eQTL_Catalogue_r4/manuscript_sumstats/GTExV8.spleen_tx.permuted.txt.gz
GTExV8.stomach_tx	/gpfs/hpc/projects/eQTLCatalogue/qtlmap/eQTL_Catalogue_r4/manuscript_sumstats/GTExV8.stomach_tx.nominal.sorted.tsv.gz	/gpfs/hpc/projects/eQTLCatalogue/qtlmap/eQTL_Catalogue_r4/manuscript_sumstats/GTExV8.stomach_tx.nominal.sorted.tsv.gz.tbi	/gpfs/hpc/projects/eQTLCatalogue/qtlmap/eQTL_Catalogue_r4/manuscript_sumstats/GTExV8.stomach_tx.permuted.txt.gz
GTExV8.testis_tx	/gpfs/hpc/projects/eQTLCatalogue/qtlmap/eQTL_Catalogue_r4/manuscript_sumstats/GTExV8.testis_tx.nominal.sorted.tsv.gz	/gpfs/hpc/projects/eQTLCatalogue/qtlmap/eQTL_Catalogue_r4/manuscript_sumstats/GTExV8.testis_tx.nominal.sorted.tsv.gz.tbi	/gpfs/hpc/projects/eQTLCatalogue/qtlmap/eQTL_Catalogue_r4/manuscript_sumstats/GTExV8.testis_tx.permuted.txt.gz
GTExV8.thyroid_tx	/gpfs/hpc/projects/eQTLCatalogue/qtlmap/eQTL_Catalogue_r4/manuscript_sumstats/GTExV8.thyroid_tx.nominal.sorted.tsv.gz	/gpfs/hpc/projects/eQTLCatalogue/qtlmap/eQTL_Catalogue_r4/manuscript_sumstats/GTExV8.thyroid_tx.nominal.sorted.tsv.gz.tbi	/gpfs/hpc/projects/eQTLCatalogue/qtlmap/eQTL_Catalogue_r4/manuscript_sumstats/GTExV8.thyroid_tx.permuted.txt.gz
GTExV8.uterus_tx	/gpfs/hpc/projects/eQTLCatalogue/qtlmap/eQTL_Catalogue_r4/manuscript_sumstats/GTExV8.uterus_tx.nominal.sorted.tsv.gz	/gpfs/hpc/projects/eQTLCatalogue/qtlmap/eQTL_Catalogue_r4/manuscript_sumstats/GTExV8.uterus_tx.nominal.sorted.tsv.gz.tbi	/gpfs/hpc/projects/eQTLCatalogue/qtlmap/eQTL_Catalogue_r4/manuscript_sumstats/GTExV8.uterus_tx.permuted.txt.gz
GTExV8.vagina_tx	/gpfs/hpc/projects/eQTLCatalogue/qtlmap/eQTL_Catalogue_r4/manuscript_sumstats/GTExV8.vagina_tx.nominal.sorted.tsv.gz	/gpfs/hpc/projects/eQTLCatalogue/qtlmap/eQTL_Catalogue_r4/manuscript_sumstats/GTExV8.vagina_tx.nominal.sorted.tsv.gz.tbi	/gpfs/hpc/projects/eQTLCatalogue/qtlmap/eQTL_Catalogue_r4/manuscript_sumstats/GTExV8.vagina_tx.permuted.txt.gz
HipSci.iPSC_tx	/gpfs/hpc/projects/eQTLCatalogue/qtlmap/eQTL_Catalogue_r4/manuscript_sumstats/HipSci.iPSC_tx.nominal.sorted.tsv.gz	/gpfs/hpc/projects/eQTLCatalogue/qtlmap/eQTL_Catalogue_r4/manuscript_sumstats/HipSci.iPSC_tx.nominal.sorted.tsv.gz.tbi	/gpfs/hpc/projects/eQTLCatalogue/qtlmap/eQTL_Catalogue_r4/manuscript_sumstats/HipSci.iPSC_tx.permuted.txt.gz
Lepik_2017.blood_tx	/gpfs/hpc/projects/eQTLCatalogue/qtlmap/eQTL_Catalogue_r4/manuscript_sumstats/Lepik_2017.blood_tx.nominal.sorted.tsv.gz	/gpfs/hpc/projects/eQTLCatalogue/qtlmap/eQTL_Catalogue_r4/manuscript_sumstats/Lepik_2017.blood_tx.nominal.sorted.tsv.gz.tbi	/gpfs/hpc/projects/eQTLCatalogue/qtlmap/eQTL_Catalogue_r4/manuscript_sumstats/Lepik_2017.blood_tx.permuted.txt.gz
Nedelec_2016.macrophage_Listeria_tx	/gpfs/hpc/projects/eQTLCatalogue/qtlmap/eQTL_Catalogue_r4/manuscript_sumstats/Nedelec_2016.macrophage_Listeria_tx.nominal.sorted.tsv.gz	/gpfs/hpc/projects/eQTLCatalogue/qtlmap/eQTL_Catalogue_r4/manuscript_sumstats/Nedelec_2016.macrophage_Listeria_tx.nominal.sorted.tsv.gz.tbi	/gpfs/hpc/projects/eQTLCatalogue/qtlmap/eQTL_Catalogue_r4/manuscript_sumstats/Nedelec_2016.macrophage_Listeria_tx.permuted.txt.gz
Nedelec_2016.macrophage_Salmonella_tx	/gpfs/hpc/projects/eQTLCatalogue/qtlmap/eQTL_Catalogue_r4/manuscript_sumstats/Nedelec_2016.macrophage_Salmonella_tx.nominal.sorted.tsv.gz	/gpfs/hpc/projects/eQTLCatalogue/qtlmap/eQTL_Catalogue_r4/manuscript_sumstats/Nedelec_2016.macrophage_Salmonella_tx.nominal.sorted.tsv.gz.tbi	/gpfs/hpc/projects/eQTLCatalogue/qtlmap/eQTL_Catalogue_r4/manuscript_sumstats/Nedelec_2016.macrophage_Salmonella_tx.permuted.txt.gz
Nedelec_2016.macrophage_naive_tx	/gpfs/hpc/projects/eQTLCatalogue/qtlmap/eQTL_Catalogue_r4/manuscript_sumstats/Nedelec_2016.macrophage_naive_tx.nominal.sorted.tsv.gz	/gpfs/hpc/projects/eQTLCatalogue/qtlmap/eQTL_Catalogue_r4/manuscript_sumstats/Nedelec_2016.macrophage_naive_tx.nominal.sorted.tsv.gz.tbi	/gpfs/hpc/projects/eQTLCatalogue/qtlmap/eQTL_Catalogue_r4/manuscript_sumstats/Nedelec_2016.macrophage_naive_tx.permuted.txt.gz
Quach_2016.monocyte_IAV_tx	/gpfs/hpc/projects/eQTLCatalogue/qtlmap/eQTL_Catalogue_r4/manuscript_sumstats/Quach_2016.monocyte_IAV_tx.nominal.sorted.tsv.gz	/gpfs/hpc/projects/eQTLCatalogue/qtlmap/eQTL_Catalogue_r4/manuscript_sumstats/Quach_2016.monocyte_IAV_tx.nominal.sorted.tsv.gz.tbi	/gpfs/hpc/projects/eQTLCatalogue/qtlmap/eQTL_Catalogue_r4/manuscript_sumstats/Quach_2016.monocyte_IAV_tx.permuted.txt.gz
Quach_2016.monocyte_LPS_tx	/gpfs/hpc/projects/eQTLCatalogue/qtlmap/eQTL_Catalogue_r4/manuscript_sumstats/Quach_2016.monocyte_LPS_tx.nominal.sorted.tsv.gz	/gpfs/hpc/projects/eQTLCatalogue/qtlmap/eQTL_Catalogue_r4/manuscript_sumstats/Quach_2016.monocyte_LPS_tx.nominal.sorted.tsv.gz.tbi	/gpfs/hpc/projects/eQTLCatalogue/qtlmap/eQTL_Catalogue_r4/manuscript_sumstats/Quach_2016.monocyte_LPS_tx.permuted.txt.gz
Quach_2016.monocyte_Pam3CSK4_tx	/gpfs/hpc/projects/eQTLCatalogue/qtlmap/eQTL_Catalogue_r4/manuscript_sumstats/Quach_2016.monocyte_Pam3CSK4_tx.nominal.sorted.tsv.gz	/gpfs/hpc/projects/eQTLCatalogue/qtlmap/eQTL_Catalogue_r4/manuscript_sumstats/Quach_2016.monocyte_Pam3CSK4_tx.nominal.sorted.tsv.gz.tbi	/gpfs/hpc/projects/eQTLCatalogue/qtlmap/eQTL_Catalogue_r4/manuscript_sumstats/Quach_2016.monocyte_Pam3CSK4_tx.permuted.txt.gz
Quach_2016.monocyte_R848_tx	/gpfs/hpc/projects/eQTLCatalogue/qtlmap/eQTL_Catalogue_r4/manuscript_sumstats/Quach_2016.monocyte_R848_tx.nominal.sorted.tsv.gz	/gpfs/hpc/projects/eQTLCatalogue/qtlmap/eQTL_Catalogue_r4/manuscript_sumstats/Quach_2016.monocyte_R848_tx.nominal.sorted.tsv.gz.tbi	/gpfs/hpc/projects/eQTLCatalogue/qtlmap/eQTL_Catalogue_r4/manuscript_sumstats/Quach_2016.monocyte_R848_tx.permuted.txt.gz
Quach_2016.monocyte_naive_tx	/gpfs/hpc/projects/eQTLCatalogue/qtlmap/eQTL_Catalogue_r4/manuscript_sumstats/Quach_2016.monocyte_naive_tx.nominal.sorted.tsv.gz	/gpfs/hpc/projects/eQTLCatalogue/qtlmap/eQTL_Catalogue_r4/manuscript_sumstats/Quach_2016.monocyte_naive_tx.nominal.sorted.tsv.gz.tbi	/gpfs/hpc/projects/eQTLCatalogue/qtlmap/eQTL_Catalogue_r4/manuscript_sumstats/Quach_2016.monocyte_naive_tx.permuted.txt.gz
ROSMAP.brain_naive_tx	/gpfs/hpc/projects/eQTLCatalogue/qtlmap/eQTL_Catalogue_r4/manuscript_sumstats/ROSMAP.brain_naive_tx.nominal.sorted.tsv.gz	/gpfs/hpc/projects/eQTLCatalogue/qtlmap/eQTL_Catalogue_r4/manuscript_sumstats/ROSMAP.brain_naive_tx.nominal.sorted.tsv.gz.tbi	/gpfs/hpc/projects/eQTLCatalogue/qtlmap/eQTL_Catalogue_r4/manuscript_sumstats/ROSMAP.brain_naive_tx.permuted.txt.gz
Schmiedel_2018.B-cell_naive_tx	/gpfs/hpc/projects/eQTLCatalogue/qtlmap/eQTL_Catalogue_r4/manuscript_sumstats/Schmiedel_2018.B-cell_naive_tx.nominal.sorted.tsv.gz	/gpfs/hpc/projects/eQTLCatalogue/qtlmap/eQTL_Catalogue_r4/manuscript_sumstats/Schmiedel_2018.B-cell_naive_tx.nominal.sorted.tsv.gz.tbi	/gpfs/hpc/projects/eQTLCatalogue/qtlmap/eQTL_Catalogue_r4/manuscript_sumstats/Schmiedel_2018.B-cell_naive_tx.permuted.txt.gz
Schmiedel_2018.CD4_T-cell_anti-CD3-CD28_tx	/gpfs/hpc/projects/eQTLCatalogue/qtlmap/eQTL_Catalogue_r4/manuscript_sumstats/Schmiedel_2018.CD4_T-cell_anti-CD3-CD28_tx.nominal.sorted.tsv.gz	/gpfs/hpc/projects/eQTLCatalogue/qtlmap/eQTL_Catalogue_r4/manuscript_sumstats/Schmiedel_2018.CD4_T-cell_anti-CD3-CD28_tx.nominal.sorted.tsv.gz.tbi	/gpfs/hpc/projects/eQTLCatalogue/qtlmap/eQTL_Catalogue_r4/manuscript_sumstats/Schmiedel_2018.CD4_T-cell_anti-CD3-CD28_tx.permuted.txt.gz
Schmiedel_2018.CD4_T-cell_naive_tx	/gpfs/hpc/projects/eQTLCatalogue/qtlmap/eQTL_Catalogue_r4/manuscript_sumstats/Schmiedel_2018.CD4_T-cell_naive_tx.nominal.sorted.tsv.gz	/gpfs/hpc/projects/eQTLCatalogue/qtlmap/eQTL_Catalogue_r4/manuscript_sumstats/Schmiedel_2018.CD4_T-cell_naive_tx.nominal.sorted.tsv.gz.tbi	/gpfs/hpc/projects/eQTLCatalogue/qtlmap/eQTL_Catalogue_r4/manuscript_sumstats/Schmiedel_2018.CD4_T-cell_naive_tx.permuted.txt.gz
Schmiedel_2018.CD8_T-cell_anti-CD3-CD28_tx	/gpfs/hpc/projects/eQTLCatalogue/qtlmap/eQTL_Catalogue_r4/manuscript_sumstats/Schmiedel_2018.CD8_T-cell_anti-CD3-CD28_tx.nominal.sorted.tsv.gz	/gpfs/hpc/projects/eQTLCatalogue/qtlmap/eQTL_Catalogue_r4/manuscript_sumstats/Schmiedel_2018.CD8_T-cell_anti-CD3-CD28_tx.nominal.sorted.tsv.gz.tbi	/gpfs/hpc/projects/eQTLCatalogue/qtlmap/eQTL_Catalogue_r4/manuscript_sumstats/Schmiedel_2018.CD8_T-cell_anti-CD3-CD28_tx.permuted.txt.gz
Schmiedel_2018.CD8_T-cell_naive_tx	/gpfs/hpc/projects/eQTLCatalogue/qtlmap/eQTL_Catalogue_r4/manuscript_sumstats/Schmiedel_2018.CD8_T-cell_naive_tx.nominal.sorted.tsv.gz	/gpfs/hpc/projects/eQTLCatalogue/qtlmap/eQTL_Catalogue_r4/manuscript_sumstats/Schmiedel_2018.CD8_T-cell_naive_tx.nominal.sorted.tsv.gz.tbi	/gpfs/hpc/projects/eQTLCatalogue/qtlmap/eQTL_Catalogue_r4/manuscript_sumstats/Schmiedel_2018.CD8_T-cell_naive_tx.permuted.txt.gz
Schmiedel_2018.NK-cell_naive_tx	/gpfs/hpc/projects/eQTLCatalogue/qtlmap/eQTL_Catalogue_r4/manuscript_sumstats/Schmiedel_2018.NK-cell_naive_tx.nominal.sorted.tsv.gz	/gpfs/hpc/projects/eQTLCatalogue/qtlmap/eQTL_Catalogue_r4/manuscript_sumstats/Schmiedel_2018.NK-cell_naive_tx.nominal.sorted.tsv.gz.tbi	/gpfs/hpc/projects/eQTLCatalogue/qtlmap/eQTL_Catalogue_r4/manuscript_sumstats/Schmiedel_2018.NK-cell_naive_tx.permuted.txt.gz
Schmiedel_2018.Tfh_memory_tx	/gpfs/hpc/projects/eQTLCatalogue/qtlmap/eQTL_Catalogue_r4/manuscript_sumstats/Schmiedel_2018.Tfh_memory_tx.nominal.sorted.tsv.gz	/gpfs/hpc/projects/eQTLCatalogue/qtlmap/eQTL_Catalogue_r4/manuscript_sumstats/Schmiedel_2018.Tfh_memory_tx.nominal.sorted.tsv.gz.tbi	/gpfs/hpc/projects/eQTLCatalogue/qtlmap/eQTL_Catalogue_r4/manuscript_sumstats/Schmiedel_2018.Tfh_memory_tx.permuted.txt.gz
Schmiedel_2018.Th1-17_memory_tx	/gpfs/hpc/projects/eQTLCatalogue/qtlmap/eQTL_Catalogue_r4/manuscript_sumstats/Schmiedel_2018.Th1-17_memory_tx.nominal.sorted.tsv.gz	/gpfs/hpc/projects/eQTLCatalogue/qtlmap/eQTL_Catalogue_r4/manuscript_sumstats/Schmiedel_2018.Th1-17_memory_tx.nominal.sorted.tsv.gz.tbi	/gpfs/hpc/projects/eQTLCatalogue/qtlmap/eQTL_Catalogue_r4/manuscript_sumstats/Schmiedel_2018.Th1-17_memory_tx.permuted.txt.gz
Schmiedel_2018.Th17_memory_tx	/gpfs/hpc/projects/eQTLCatalogue/qtlmap/eQTL_Catalogue_r4/manuscript_sumstats/Schmiedel_2018.Th17_memory_tx.nominal.sorted.tsv.gz	/gpfs/hpc/projects/eQTLCatalogue/qtlmap/eQTL_Catalogue_r4/manuscript_sumstats/Schmiedel_2018.Th17_memory_tx.nominal.sorted.tsv.gz.tbi	/gpfs/hpc/projects/eQTLCatalogue/qtlmap/eQTL_Catalogue_r4/manuscript_sumstats/Schmiedel_2018.Th17_memory_tx.permuted.txt.gz
Schmiedel_2018.Th1_memory_tx	/gpfs/hpc/projects/eQTLCatalogue/qtlmap/eQTL_Catalogue_r4/manuscript_sumstats/Schmiedel_2018.Th1_memory_tx.nominal.sorted.tsv.gz	/gpfs/hpc/projects/eQTLCatalogue/qtlmap/eQTL_Catalogue_r4/manuscript_sumstats/Schmiedel_2018.Th1_memory_tx.nominal.sorted.tsv.gz.tbi	/gpfs/hpc/projects/eQTLCatalogue/qtlmap/eQTL_Catalogue_r4/manuscript_sumstats/Schmiedel_2018.Th1_memory_tx.permuted.txt.gz
Schmiedel_2018.Th2_memory_tx	/gpfs/hpc/projects/eQTLCatalogue/qtlmap/eQTL_Catalogue_r4/manuscript_sumstats/Schmiedel_2018.Th2_memory_tx.nominal.sorted.tsv.gz	/gpfs/hpc/projects/eQTLCatalogue/qtlmap/eQTL_Catalogue_r4/manuscript_sumstats/Schmiedel_2018.Th2_memory_tx.nominal.sorted.tsv.gz.tbi	/gpfs/hpc/projects/eQTLCatalogue/qtlmap/eQTL_Catalogue_r4/manuscript_sumstats/Schmiedel_2018.Th2_memory_tx.permuted.txt.gz
Schmiedel_2018.Treg_memory_tx	/gpfs/hpc/projects/eQTLCatalogue/qtlmap/eQTL_Catalogue_r4/manuscript_sumstats/Schmiedel_2018.Treg_memory_tx.nominal.sorted.tsv.gz	/gpfs/hpc/projects/eQTLCatalogue/qtlmap/eQTL_Catalogue_r4/manuscript_sumstats/Schmiedel_2018.Treg_memory_tx.nominal.sorted.tsv.gz.tbi	/gpfs/hpc/projects/eQTLCatalogue/qtlmap/eQTL_Catalogue_r4/manuscript_sumstats/Schmiedel_2018.Treg_memory_tx.permuted.txt.gz
Schmiedel_2018.Treg_naive_tx	/gpfs/hpc/projects/eQTLCatalogue/qtlmap/eQTL_Catalogue_r4/manuscript_sumstats/Schmiedel_2018.Treg_naive_tx.nominal.sorted.tsv.gz	/gpfs/hpc/projects/eQTLCatalogue/qtlmap/eQTL_Catalogue_r4/manuscript_sumstats/Schmiedel_2018.Treg_naive_tx.nominal.sorted.tsv.gz.tbi	/gpfs/hpc/projects/eQTLCatalogue/qtlmap/eQTL_Catalogue_r4/manuscript_sumstats/Schmiedel_2018.Treg_naive_tx.permuted.txt.gz
Schmiedel_2018.monocyte_CD16_naive_tx	/gpfs/hpc/projects/eQTLCatalogue/qtlmap/eQTL_Catalogue_r4/manuscript_sumstats/Schmiedel_2018.monocyte_CD16_naive_tx.nominal.sorted.tsv.gz	/gpfs/hpc/projects/eQTLCatalogue/qtlmap/eQTL_Catalogue_r4/manuscript_sumstats/Schmiedel_2018.monocyte_CD16_naive_tx.nominal.sorted.tsv.gz.tbi	/gpfs/hpc/projects/eQTLCatalogue/qtlmap/eQTL_Catalogue_r4/manuscript_sumstats/Schmiedel_2018.monocyte_CD16_naive_tx.permuted.txt.gz
Schmiedel_2018.monocyte_naive_tx	/gpfs/hpc/projects/eQTLCatalogue/qtlmap/eQTL_Catalogue_r4/manuscript_sumstats/Schmiedel_2018.monocyte_naive_tx.nominal.sorted.tsv.gz	/gpfs/hpc/projects/eQTLCatalogue/qtlmap/eQTL_Catalogue_r4/manuscript_sumstats/Schmiedel_2018.monocyte_naive_tx.nominal.sorted.tsv.gz.tbi	/gpfs/hpc/projects/eQTLCatalogue/qtlmap/eQTL_Catalogue_r4/manuscript_sumstats/Schmiedel_2018.monocyte_naive_tx.permuted.txt.gz
Schwartzentruber_2018.sensory_neuron_tx	/gpfs/hpc/projects/eQTLCatalogue/qtlmap/eQTL_Catalogue_r4/manuscript_sumstats/Schwartzentruber_2018.sensory_neuron_tx.nominal.sorted.tsv.gz	/gpfs/hpc/projects/eQTLCatalogue/qtlmap/eQTL_Catalogue_r4/manuscript_sumstats/Schwartzentruber_2018.sensory_neuron_tx.nominal.sorted.tsv.gz.tbi	/gpfs/hpc/projects/eQTLCatalogue/qtlmap/eQTL_Catalogue_r4/manuscript_sumstats/Schwartzentruber_2018.sensory_neuron_tx.permuted.txt.gz
TwinsUK.LCL_tx	/gpfs/hpc/projects/eQTLCatalogue/qtlmap/eQTL_Catalogue_r4/manuscript_sumstats/TwinsUK.LCL_tx.nominal.sorted.tsv.gz	/gpfs/hpc/projects/eQTLCatalogue/qtlmap/eQTL_Catalogue_r4/manuscript_sumstats/TwinsUK.LCL_tx.nominal.sorted.tsv.gz.tbi	/gpfs/hpc/projects/eQTLCatalogue/qtlmap/eQTL_Catalogue_r4/manuscript_sumstats/TwinsUK.LCL_tx.permuted.txt.gz
TwinsUK.blood_tx	/gpfs/hpc/projects/eQTLCatalogue/qtlmap/eQTL_Catalogue_r4/manuscript_sumstats/TwinsUK.blood_tx.nominal.sorted.tsv.gz	/gpfs/hpc/projects/eQTLCatalogue/qtlmap/eQTL_Catalogue_r4/manuscript_sumstats/TwinsUK.blood_tx.nominal.sorted.tsv.gz.tbi	/gpfs/hpc/projects/eQTLCatalogue/qtlmap/eQTL_Catalogue_r4/manuscript_sumstats/TwinsUK.blood_tx.permuted.txt.gz
TwinsUK.fat_tx	/gpfs/hpc/projects/eQTLCatalogue/qtlmap/eQTL_Catalogue_r4/manuscript_sumstats/TwinsUK.fat_tx.nominal.sorted.tsv.gz	/gpfs/hpc/projects/eQTLCatalogue/qtlmap/eQTL_Catalogue_r4/manuscript_sumstats/TwinsUK.fat_tx.nominal.sorted.tsv.gz.tbi	/gpfs/hpc/projects/eQTLCatalogue/qtlmap/eQTL_Catalogue_r4/manuscript_sumstats/TwinsUK.fat_tx.permuted.txt.gz
TwinsUK.skin_tx	/gpfs/hpc/projects/eQTLCatalogue/qtlmap/eQTL_Catalogue_r4/manuscript_sumstats/TwinsUK.skin_tx.nominal.sorted.tsv.gz	/gpfs/hpc/projects/eQTLCatalogue/qtlmap/eQTL_Catalogue_r4/manuscript_sumstats/TwinsUK.skin_tx.nominal.sorted.tsv.gz.tbi	/gpfs/hpc/projects/eQTLCatalogue/qtlmap/eQTL_Catalogue_r4/manuscript_sumstats/TwinsUK.skin_tx.permuted.txt.gz
van_de_Bunt_2015.pancreatic_islet_tx	/gpfs/hpc/projects/eQTLCatalogue/qtlmap/eQTL_Catalogue_r4/manuscript_sumstats/van_de_Bunt_2015.pancreatic_islet_tx.nominal.sorted.tsv.gz	/gpfs/hpc/projects/eQTLCatalogue/qtlmap/eQTL_Catalogue_r4/manuscript_sumstats/van_de_Bunt_2015.pancreatic_islet_tx.nominal.sorted.tsv.gz.tbi	/gpfs/hpc/projects/eQTLCatalogue/qtlmap/eQTL_Catalogue_r4/manuscript_sumstats/van_de_Bunt_2015.pancreatic_islet_tx.permuted.txt.gz