qtl_subset	qtl_ss	qtl_ss_index	qtl_credible_set_or_perm
Alasoo_2018.macrophage_IFNg+Salmonella_txrev	/gpfs/hpc/projects/eQTLCatalogue/qtlmap/eQTL_Catalogue_r4/manuscript_sumstats/Alasoo_2018.macrophage_IFNg+Salmonella_txrev.nominal.sorted.tsv.gz	/gpfs/hpc/projects/eQTLCatalogue/qtlmap/eQTL_Catalogue_r4/manuscript_sumstats/Alasoo_2018.macrophage_IFNg+Salmonella_txrev.nominal.sorted.tsv.gz.tbi	/gpfs/hpc/projects/eQTLCatalogue/qtlmap/eQTL_Catalogue_r4/manuscript_sumstats/Alasoo_2018.macrophage_IFNg+Salmonella_txrev.permuted.txt.gz
Alasoo_2018.macrophage_IFNg_txrev	/gpfs/hpc/projects/eQTLCatalogue/qtlmap/eQTL_Catalogue_r4/manuscript_sumstats/Alasoo_2018.macrophage_IFNg_txrev.nominal.sorted.tsv.gz	/gpfs/hpc/projects/eQTLCatalogue/qtlmap/eQTL_Catalogue_r4/manuscript_sumstats/Alasoo_2018.macrophage_IFNg_txrev.nominal.sorted.tsv.gz.tbi	/gpfs/hpc/projects/eQTLCatalogue/qtlmap/eQTL_Catalogue_r4/manuscript_sumstats/Alasoo_2018.macrophage_IFNg_txrev.permuted.txt.gz
Alasoo_2018.macrophage_Salmonella_txrev	/gpfs/hpc/projects/eQTLCatalogue/qtlmap/eQTL_Catalogue_r4/manuscript_sumstats/Alasoo_2018.macrophage_Salmonella_txrev.nominal.sorted.tsv.gz	/gpfs/hpc/projects/eQTLCatalogue/qtlmap/eQTL_Catalogue_r4/manuscript_sumstats/Alasoo_2018.macrophage_Salmonella_txrev.nominal.sorted.tsv.gz.tbi	/gpfs/hpc/projects/eQTLCatalogue/qtlmap/eQTL_Catalogue_r4/manuscript_sumstats/Alasoo_2018.macrophage_Salmonella_txrev.permuted.txt.gz
Alasoo_2018.macrophage_naive_txrev	/gpfs/hpc/projects/eQTLCatalogue/qtlmap/eQTL_Catalogue_r4/manuscript_sumstats/Alasoo_2018.macrophage_naive_txrev.nominal.sorted.tsv.gz	/gpfs/hpc/projects/eQTLCatalogue/qtlmap/eQTL_Catalogue_r4/manuscript_sumstats/Alasoo_2018.macrophage_naive_txrev.nominal.sorted.tsv.gz.tbi	/gpfs/hpc/projects/eQTLCatalogue/qtlmap/eQTL_Catalogue_r4/manuscript_sumstats/Alasoo_2018.macrophage_naive_txrev.permuted.txt.gz
BLUEPRINT_PE.T-cell_txrev	/gpfs/hpc/projects/eQTLCatalogue/qtlmap/eQTL_Catalogue_r4/manuscript_sumstats/BLUEPRINT_PE.T-cell_txrev.nominal.sorted.tsv.gz	/gpfs/hpc/projects/eQTLCatalogue/qtlmap/eQTL_Catalogue_r4/manuscript_sumstats/BLUEPRINT_PE.T-cell_txrev.nominal.sorted.tsv.gz.tbi	/gpfs/hpc/projects/eQTLCatalogue/qtlmap/eQTL_Catalogue_r4/manuscript_sumstats/BLUEPRINT_PE.T-cell_txrev.permuted.txt.gz
BLUEPRINT_SE.monocyte_txrev	/gpfs/hpc/projects/eQTLCatalogue/qtlmap/eQTL_Catalogue_r4/manuscript_sumstats/BLUEPRINT_SE.monocyte_txrev.nominal.sorted.tsv.gz	/gpfs/hpc/projects/eQTLCatalogue/qtlmap/eQTL_Catalogue_r4/manuscript_sumstats/BLUEPRINT_SE.monocyte_txrev.nominal.sorted.tsv.gz.tbi	/gpfs/hpc/projects/eQTLCatalogue/qtlmap/eQTL_Catalogue_r4/manuscript_sumstats/BLUEPRINT_SE.monocyte_txrev.permuted.txt.gz
BLUEPRINT_SE.neutrophil_txrev	/gpfs/hpc/projects/eQTLCatalogue/qtlmap/eQTL_Catalogue_r4/manuscript_sumstats/BLUEPRINT_SE.neutrophil_txrev.nominal.sorted.tsv.gz	/gpfs/hpc/projects/eQTLCatalogue/qtlmap/eQTL_Catalogue_r4/manuscript_sumstats/BLUEPRINT_SE.neutrophil_txrev.nominal.sorted.tsv.gz.tbi	/gpfs/hpc/projects/eQTLCatalogue/qtlmap/eQTL_Catalogue_r4/manuscript_sumstats/BLUEPRINT_SE.neutrophil_txrev.permuted.txt.gz
BrainSeq.brain_txrev	/gpfs/hpc/projects/eQTLCatalogue/qtlmap/eQTL_Catalogue_r4/manuscript_sumstats/BrainSeq.brain_txrev.nominal.sorted.tsv.gz	/gpfs/hpc/projects/eQTLCatalogue/qtlmap/eQTL_Catalogue_r4/manuscript_sumstats/BrainSeq.brain_txrev.nominal.sorted.tsv.gz.tbi	/gpfs/hpc/projects/eQTLCatalogue/qtlmap/eQTL_Catalogue_r4/manuscript_sumstats/BrainSeq.brain_txrev.permuted.txt.gz
FUSION.adipose_naive_txrev	/gpfs/hpc/projects/eQTLCatalogue/qtlmap/eQTL_Catalogue_r4/manuscript_sumstats/FUSION.adipose_naive_txrev.nominal.sorted.tsv.gz	/gpfs/hpc/projects/eQTLCatalogue/qtlmap/eQTL_Catalogue_r4/manuscript_sumstats/FUSION.adipose_naive_txrev.nominal.sorted.tsv.gz.tbi	/gpfs/hpc/projects/eQTLCatalogue/qtlmap/eQTL_Catalogue_r4/manuscript_sumstats/FUSION.adipose_naive_txrev.permuted.txt.gz
FUSION.muscle_naive_txrev	/gpfs/hpc/projects/eQTLCatalogue/qtlmap/eQTL_Catalogue_r4/manuscript_sumstats/FUSION.muscle_naive_txrev.nominal.sorted.tsv.gz	/gpfs/hpc/projects/eQTLCatalogue/qtlmap/eQTL_Catalogue_r4/manuscript_sumstats/FUSION.muscle_naive_txrev.nominal.sorted.tsv.gz.tbi	/gpfs/hpc/projects/eQTLCatalogue/qtlmap/eQTL_Catalogue_r4/manuscript_sumstats/FUSION.muscle_naive_txrev.permuted.txt.gz
GENCORD.LCL_txrev	/gpfs/hpc/projects/eQTLCatalogue/qtlmap/eQTL_Catalogue_r4/manuscript_sumstats/GENCORD.LCL_txrev.nominal.sorted.tsv.gz	/gpfs/hpc/projects/eQTLCatalogue/qtlmap/eQTL_Catalogue_r4/manuscript_sumstats/GENCORD.LCL_txrev.nominal.sorted.tsv.gz.tbi	/gpfs/hpc/projects/eQTLCatalogue/qtlmap/eQTL_Catalogue_r4/manuscript_sumstats/GENCORD.LCL_txrev.permuted.txt.gz
GENCORD.T-cell_txrev	/gpfs/hpc/projects/eQTLCatalogue/qtlmap/eQTL_Catalogue_r4/manuscript_sumstats/GENCORD.T-cell_txrev.nominal.sorted.tsv.gz	/gpfs/hpc/projects/eQTLCatalogue/qtlmap/eQTL_Catalogue_r4/manuscript_sumstats/GENCORD.T-cell_txrev.nominal.sorted.tsv.gz.tbi	/gpfs/hpc/projects/eQTLCatalogue/qtlmap/eQTL_Catalogue_r4/manuscript_sumstats/GENCORD.T-cell_txrev.permuted.txt.gz
GENCORD.fibroblast_txrev	/gpfs/hpc/projects/eQTLCatalogue/qtlmap/eQTL_Catalogue_r4/manuscript_sumstats/GENCORD.fibroblast_txrev.nominal.sorted.tsv.gz	/gpfs/hpc/projects/eQTLCatalogue/qtlmap/eQTL_Catalogue_r4/manuscript_sumstats/GENCORD.fibroblast_txrev.nominal.sorted.tsv.gz.tbi	/gpfs/hpc/projects/eQTLCatalogue/qtlmap/eQTL_Catalogue_r4/manuscript_sumstats/GENCORD.fibroblast_txrev.permuted.txt.gz
GEUVADIS.LCL_txrev	/gpfs/hpc/projects/eQTLCatalogue/qtlmap/eQTL_Catalogue_r4/manuscript_sumstats/GEUVADIS.LCL_txrev.nominal.sorted.tsv.gz	/gpfs/hpc/projects/eQTLCatalogue/qtlmap/eQTL_Catalogue_r4/manuscript_sumstats/GEUVADIS.LCL_txrev.nominal.sorted.tsv.gz.tbi	/gpfs/hpc/projects/eQTLCatalogue/qtlmap/eQTL_Catalogue_r4/manuscript_sumstats/GEUVADIS.LCL_txrev.permuted.txt.gz
GTExV8.LCL_txrev	/gpfs/hpc/projects/eQTLCatalogue/qtlmap/eQTL_Catalogue_r4/manuscript_sumstats/GTExV8.LCL_txrev.nominal.sorted.tsv.gz	/gpfs/hpc/projects/eQTLCatalogue/qtlmap/eQTL_Catalogue_r4/manuscript_sumstats/GTExV8.LCL_txrev.nominal.sorted.tsv.gz.tbi	/gpfs/hpc/projects/eQTLCatalogue/qtlmap/eQTL_Catalogue_r4/manuscript_sumstats/GTExV8.LCL_txrev.permuted.txt.gz
GTExV8.adipose_subcutaneous_txrev	/gpfs/hpc/projects/eQTLCatalogue/qtlmap/eQTL_Catalogue_r4/manuscript_sumstats/GTExV8.adipose_subcutaneous_txrev.nominal.sorted.tsv.gz	/gpfs/hpc/projects/eQTLCatalogue/qtlmap/eQTL_Catalogue_r4/manuscript_sumstats/GTExV8.adipose_subcutaneous_txrev.nominal.sorted.tsv.gz.tbi	/gpfs/hpc/projects/eQTLCatalogue/qtlmap/eQTL_Catalogue_r4/manuscript_sumstats/GTExV8.adipose_subcutaneous_txrev.permuted.txt.gz
GTExV8.adipose_visceral_txrev	/gpfs/hpc/projects/eQTLCatalogue/qtlmap/eQTL_Catalogue_r4/manuscript_sumstats/GTExV8.adipose_visceral_txrev.nominal.sorted.tsv.gz	/gpfs/hpc/projects/eQTLCatalogue/qtlmap/eQTL_Catalogue_r4/manuscript_sumstats/GTExV8.adipose_visceral_txrev.nominal.sorted.tsv.gz.tbi	/gpfs/hpc/projects/eQTLCatalogue/qtlmap/eQTL_Catalogue_r4/manuscript_sumstats/GTExV8.adipose_visceral_txrev.permuted.txt.gz
GTExV8.adrenal_gland_txrev	/gpfs/hpc/projects/eQTLCatalogue/qtlmap/eQTL_Catalogue_r4/manuscript_sumstats/GTExV8.adrenal_gland_txrev.nominal.sorted.tsv.gz	/gpfs/hpc/projects/eQTLCatalogue/qtlmap/eQTL_Catalogue_r4/manuscript_sumstats/GTExV8.adrenal_gland_txrev.nominal.sorted.tsv.gz.tbi	/gpfs/hpc/projects/eQTLCatalogue/qtlmap/eQTL_Catalogue_r4/manuscript_sumstats/GTExV8.adrenal_gland_txrev.permuted.txt.gz
GTExV8.artery_aorta_txrev	/gpfs/hpc/projects/eQTLCatalogue/qtlmap/eQTL_Catalogue_r4/manuscript_sumstats/GTExV8.artery_aorta_txrev.nominal.sorted.tsv.gz	/gpfs/hpc/projects/eQTLCatalogue/qtlmap/eQTL_Catalogue_r4/manuscript_sumstats/GTExV8.artery_aorta_txrev.nominal.sorted.tsv.gz.tbi	/gpfs/hpc/projects/eQTLCatalogue/qtlmap/eQTL_Catalogue_r4/manuscript_sumstats/GTExV8.artery_aorta_txrev.permuted.txt.gz
GTExV8.artery_coronary_txrev	/gpfs/hpc/projects/eQTLCatalogue/qtlmap/eQTL_Catalogue_r4/manuscript_sumstats/GTExV8.artery_coronary_txrev.nominal.sorted.tsv.gz	/gpfs/hpc/projects/eQTLCatalogue/qtlmap/eQTL_Catalogue_r4/manuscript_sumstats/GTExV8.artery_coronary_txrev.nominal.sorted.tsv.gz.tbi	/gpfs/hpc/projects/eQTLCatalogue/qtlmap/eQTL_Catalogue_r4/manuscript_sumstats/GTExV8.artery_coronary_txrev.permuted.txt.gz
GTExV8.artery_tibial_txrev	/gpfs/hpc/projects/eQTLCatalogue/qtlmap/eQTL_Catalogue_r4/manuscript_sumstats/GTExV8.artery_tibial_txrev.nominal.sorted.tsv.gz	/gpfs/hpc/projects/eQTLCatalogue/qtlmap/eQTL_Catalogue_r4/manuscript_sumstats/GTExV8.artery_tibial_txrev.nominal.sorted.tsv.gz.tbi	/gpfs/hpc/projects/eQTLCatalogue/qtlmap/eQTL_Catalogue_r4/manuscript_sumstats/GTExV8.artery_tibial_txrev.permuted.txt.gz
GTExV8.blood_txrev	/gpfs/hpc/projects/eQTLCatalogue/qtlmap/eQTL_Catalogue_r4/manuscript_sumstats/GTExV8.blood_txrev.nominal.sorted.tsv.gz	/gpfs/hpc/projects/eQTLCatalogue/qtlmap/eQTL_Catalogue_r4/manuscript_sumstats/GTExV8.blood_txrev.nominal.sorted.tsv.gz.tbi	/gpfs/hpc/projects/eQTLCatalogue/qtlmap/eQTL_Catalogue_r4/manuscript_sumstats/GTExV8.blood_txrev.permuted.txt.gz
GTExV8.brain_amygdala_txrev	/gpfs/hpc/projects/eQTLCatalogue/qtlmap/eQTL_Catalogue_r4/manuscript_sumstats/GTExV8.brain_amygdala_txrev.nominal.sorted.tsv.gz	/gpfs/hpc/projects/eQTLCatalogue/qtlmap/eQTL_Catalogue_r4/manuscript_sumstats/GTExV8.brain_amygdala_txrev.nominal.sorted.tsv.gz.tbi	/gpfs/hpc/projects/eQTLCatalogue/qtlmap/eQTL_Catalogue_r4/manuscript_sumstats/GTExV8.brain_amygdala_txrev.permuted.txt.gz
GTExV8.brain_anterior_cingulate_cortex_txrev	/gpfs/hpc/projects/eQTLCatalogue/qtlmap/eQTL_Catalogue_r4/manuscript_sumstats/GTExV8.brain_anterior_cingulate_cortex_txrev.nominal.sorted.tsv.gz	/gpfs/hpc/projects/eQTLCatalogue/qtlmap/eQTL_Catalogue_r4/manuscript_sumstats/GTExV8.brain_anterior_cingulate_cortex_txrev.nominal.sorted.tsv.gz.tbi	/gpfs/hpc/projects/eQTLCatalogue/qtlmap/eQTL_Catalogue_r4/manuscript_sumstats/GTExV8.brain_anterior_cingulate_cortex_txrev.permuted.txt.gz
GTExV8.brain_caudate_txrev	/gpfs/hpc/projects/eQTLCatalogue/qtlmap/eQTL_Catalogue_r4/manuscript_sumstats/GTExV8.brain_caudate_txrev.nominal.sorted.tsv.gz	/gpfs/hpc/projects/eQTLCatalogue/qtlmap/eQTL_Catalogue_r4/manuscript_sumstats/GTExV8.brain_caudate_txrev.nominal.sorted.tsv.gz.tbi	/gpfs/hpc/projects/eQTLCatalogue/qtlmap/eQTL_Catalogue_r4/manuscript_sumstats/GTExV8.brain_caudate_txrev.permuted.txt.gz
GTExV8.brain_cerebellar_hemisphere_txrev	/gpfs/hpc/projects/eQTLCatalogue/qtlmap/eQTL_Catalogue_r4/manuscript_sumstats/GTExV8.brain_cerebellar_hemisphere_txrev.nominal.sorted.tsv.gz	/gpfs/hpc/projects/eQTLCatalogue/qtlmap/eQTL_Catalogue_r4/manuscript_sumstats/GTExV8.brain_cerebellar_hemisphere_txrev.nominal.sorted.tsv.gz.tbi	/gpfs/hpc/projects/eQTLCatalogue/qtlmap/eQTL_Catalogue_r4/manuscript_sumstats/GTExV8.brain_cerebellar_hemisphere_txrev.permuted.txt.gz
GTExV8.brain_cerebellum_txrev	/gpfs/hpc/projects/eQTLCatalogue/qtlmap/eQTL_Catalogue_r4/manuscript_sumstats/GTExV8.brain_cerebellum_txrev.nominal.sorted.tsv.gz	/gpfs/hpc/projects/eQTLCatalogue/qtlmap/eQTL_Catalogue_r4/manuscript_sumstats/GTExV8.brain_cerebellum_txrev.nominal.sorted.tsv.gz.tbi	/gpfs/hpc/projects/eQTLCatalogue/qtlmap/eQTL_Catalogue_r4/manuscript_sumstats/GTExV8.brain_cerebellum_txrev.permuted.txt.gz
GTExV8.brain_cortex_txrev	/gpfs/hpc/projects/eQTLCatalogue/qtlmap/eQTL_Catalogue_r4/manuscript_sumstats/GTExV8.brain_cortex_txrev.nominal.sorted.tsv.gz	/gpfs/hpc/projects/eQTLCatalogue/qtlmap/eQTL_Catalogue_r4/manuscript_sumstats/GTExV8.brain_cortex_txrev.nominal.sorted.tsv.gz.tbi	/gpfs/hpc/projects/eQTLCatalogue/qtlmap/eQTL_Catalogue_r4/manuscript_sumstats/GTExV8.brain_cortex_txrev.permuted.txt.gz
GTExV8.brain_frontal_cortex_txrev	/gpfs/hpc/projects/eQTLCatalogue/qtlmap/eQTL_Catalogue_r4/manuscript_sumstats/GTExV8.brain_frontal_cortex_txrev.nominal.sorted.tsv.gz	/gpfs/hpc/projects/eQTLCatalogue/qtlmap/eQTL_Catalogue_r4/manuscript_sumstats/GTExV8.brain_frontal_cortex_txrev.nominal.sorted.tsv.gz.tbi	/gpfs/hpc/projects/eQTLCatalogue/qtlmap/eQTL_Catalogue_r4/manuscript_sumstats/GTExV8.brain_frontal_cortex_txrev.permuted.txt.gz
GTExV8.brain_hippocampus_txrev	/gpfs/hpc/projects/eQTLCatalogue/qtlmap/eQTL_Catalogue_r4/manuscript_sumstats/GTExV8.brain_hippocampus_txrev.nominal.sorted.tsv.gz	/gpfs/hpc/projects/eQTLCatalogue/qtlmap/eQTL_Catalogue_r4/manuscript_sumstats/GTExV8.brain_hippocampus_txrev.nominal.sorted.tsv.gz.tbi	/gpfs/hpc/projects/eQTLCatalogue/qtlmap/eQTL_Catalogue_r4/manuscript_sumstats/GTExV8.brain_hippocampus_txrev.permuted.txt.gz
GTExV8.brain_hypothalamus_txrev	/gpfs/hpc/projects/eQTLCatalogue/qtlmap/eQTL_Catalogue_r4/manuscript_sumstats/GTExV8.brain_hypothalamus_txrev.nominal.sorted.tsv.gz	/gpfs/hpc/projects/eQTLCatalogue/qtlmap/eQTL_Catalogue_r4/manuscript_sumstats/GTExV8.brain_hypothalamus_txrev.nominal.sorted.tsv.gz.tbi	/gpfs/hpc/projects/eQTLCatalogue/qtlmap/eQTL_Catalogue_r4/manuscript_sumstats/GTExV8.brain_hypothalamus_txrev.permuted.txt.gz
GTExV8.brain_nucleus_accumbens_txrev	/gpfs/hpc/projects/eQTLCatalogue/qtlmap/eQTL_Catalogue_r4/manuscript_sumstats/GTExV8.brain_nucleus_accumbens_txrev.nominal.sorted.tsv.gz	/gpfs/hpc/projects/eQTLCatalogue/qtlmap/eQTL_Catalogue_r4/manuscript_sumstats/GTExV8.brain_nucleus_accumbens_txrev.nominal.sorted.tsv.gz.tbi	/gpfs/hpc/projects/eQTLCatalogue/qtlmap/eQTL_Catalogue_r4/manuscript_sumstats/GTExV8.brain_nucleus_accumbens_txrev.permuted.txt.gz
GTExV8.brain_putamen_txrev	/gpfs/hpc/projects/eQTLCatalogue/qtlmap/eQTL_Catalogue_r4/manuscript_sumstats/GTExV8.brain_putamen_txrev.nominal.sorted.tsv.gz	/gpfs/hpc/projects/eQTLCatalogue/qtlmap/eQTL_Catalogue_r4/manuscript_sumstats/GTExV8.brain_putamen_txrev.nominal.sorted.tsv.gz.tbi	/gpfs/hpc/projects/eQTLCatalogue/qtlmap/eQTL_Catalogue_r4/manuscript_sumstats/GTExV8.brain_putamen_txrev.permuted.txt.gz
GTExV8.brain_spinal_cord_txrev	/gpfs/hpc/projects/eQTLCatalogue/qtlmap/eQTL_Catalogue_r4/manuscript_sumstats/GTExV8.brain_spinal_cord_txrev.nominal.sorted.tsv.gz	/gpfs/hpc/projects/eQTLCatalogue/qtlmap/eQTL_Catalogue_r4/manuscript_sumstats/GTExV8.brain_spinal_cord_txrev.nominal.sorted.tsv.gz.tbi	/gpfs/hpc/projects/eQTLCatalogue/qtlmap/eQTL_Catalogue_r4/manuscript_sumstats/GTExV8.brain_spinal_cord_txrev.permuted.txt.gz
GTExV8.brain_substantia_nigra_txrev	/gpfs/hpc/projects/eQTLCatalogue/qtlmap/eQTL_Catalogue_r4/manuscript_sumstats/GTExV8.brain_substantia_nigra_txrev.nominal.sorted.tsv.gz	/gpfs/hpc/projects/eQTLCatalogue/qtlmap/eQTL_Catalogue_r4/manuscript_sumstats/GTExV8.brain_substantia_nigra_txrev.nominal.sorted.tsv.gz.tbi	/gpfs/hpc/projects/eQTLCatalogue/qtlmap/eQTL_Catalogue_r4/manuscript_sumstats/GTExV8.brain_substantia_nigra_txrev.permuted.txt.gz
GTExV8.breast_txrev	/gpfs/hpc/projects/eQTLCatalogue/qtlmap/eQTL_Catalogue_r4/manuscript_sumstats/GTExV8.breast_txrev.nominal.sorted.tsv.gz	/gpfs/hpc/projects/eQTLCatalogue/qtlmap/eQTL_Catalogue_r4/manuscript_sumstats/GTExV8.breast_txrev.nominal.sorted.tsv.gz.tbi	/gpfs/hpc/projects/eQTLCatalogue/qtlmap/eQTL_Catalogue_r4/manuscript_sumstats/GTExV8.breast_txrev.permuted.txt.gz
GTExV8.colon_sigmoid_txrev	/gpfs/hpc/projects/eQTLCatalogue/qtlmap/eQTL_Catalogue_r4/manuscript_sumstats/GTExV8.colon_sigmoid_txrev.nominal.sorted.tsv.gz	/gpfs/hpc/projects/eQTLCatalogue/qtlmap/eQTL_Catalogue_r4/manuscript_sumstats/GTExV8.colon_sigmoid_txrev.nominal.sorted.tsv.gz.tbi	/gpfs/hpc/projects/eQTLCatalogue/qtlmap/eQTL_Catalogue_r4/manuscript_sumstats/GTExV8.colon_sigmoid_txrev.permuted.txt.gz
GTExV8.colon_transverse_txrev	/gpfs/hpc/projects/eQTLCatalogue/qtlmap/eQTL_Catalogue_r4/manuscript_sumstats/GTExV8.colon_transverse_txrev.nominal.sorted.tsv.gz	/gpfs/hpc/projects/eQTLCatalogue/qtlmap/eQTL_Catalogue_r4/manuscript_sumstats/GTExV8.colon_transverse_txrev.nominal.sorted.tsv.gz.tbi	/gpfs/hpc/projects/eQTLCatalogue/qtlmap/eQTL_Catalogue_r4/manuscript_sumstats/GTExV8.colon_transverse_txrev.permuted.txt.gz
GTExV8.esophagus_gej_txrev	/gpfs/hpc/projects/eQTLCatalogue/qtlmap/eQTL_Catalogue_r4/manuscript_sumstats/GTExV8.esophagus_gej_txrev.nominal.sorted.tsv.gz	/gpfs/hpc/projects/eQTLCatalogue/qtlmap/eQTL_Catalogue_r4/manuscript_sumstats/GTExV8.esophagus_gej_txrev.nominal.sorted.tsv.gz.tbi	/gpfs/hpc/projects/eQTLCatalogue/qtlmap/eQTL_Catalogue_r4/manuscript_sumstats/GTExV8.esophagus_gej_txrev.permuted.txt.gz
GTExV8.esophagus_mucosa_txrev	/gpfs/hpc/projects/eQTLCatalogue/qtlmap/eQTL_Catalogue_r4/manuscript_sumstats/GTExV8.esophagus_mucosa_txrev.nominal.sorted.tsv.gz	/gpfs/hpc/projects/eQTLCatalogue/qtlmap/eQTL_Catalogue_r4/manuscript_sumstats/GTExV8.esophagus_mucosa_txrev.nominal.sorted.tsv.gz.tbi	/gpfs/hpc/projects/eQTLCatalogue/qtlmap/eQTL_Catalogue_r4/manuscript_sumstats/GTExV8.esophagus_mucosa_txrev.permuted.txt.gz
GTExV8.esophagus_muscularis_txrev	/gpfs/hpc/projects/eQTLCatalogue/qtlmap/eQTL_Catalogue_r4/manuscript_sumstats/GTExV8.esophagus_muscularis_txrev.nominal.sorted.tsv.gz	/gpfs/hpc/projects/eQTLCatalogue/qtlmap/eQTL_Catalogue_r4/manuscript_sumstats/GTExV8.esophagus_muscularis_txrev.nominal.sorted.tsv.gz.tbi	/gpfs/hpc/projects/eQTLCatalogue/qtlmap/eQTL_Catalogue_r4/manuscript_sumstats/GTExV8.esophagus_muscularis_txrev.permuted.txt.gz
GTExV8.fibroblast_txrev	/gpfs/hpc/projects/eQTLCatalogue/qtlmap/eQTL_Catalogue_r4/manuscript_sumstats/GTExV8.fibroblast_txrev.nominal.sorted.tsv.gz	/gpfs/hpc/projects/eQTLCatalogue/qtlmap/eQTL_Catalogue_r4/manuscript_sumstats/GTExV8.fibroblast_txrev.nominal.sorted.tsv.gz.tbi	/gpfs/hpc/projects/eQTLCatalogue/qtlmap/eQTL_Catalogue_r4/manuscript_sumstats/GTExV8.fibroblast_txrev.permuted.txt.gz
GTExV8.heart_atrial_appendage_txrev	/gpfs/hpc/projects/eQTLCatalogue/qtlmap/eQTL_Catalogue_r4/manuscript_sumstats/GTExV8.heart_atrial_appendage_txrev.nominal.sorted.tsv.gz	/gpfs/hpc/projects/eQTLCatalogue/qtlmap/eQTL_Catalogue_r4/manuscript_sumstats/GTExV8.heart_atrial_appendage_txrev.nominal.sorted.tsv.gz.tbi	/gpfs/hpc/projects/eQTLCatalogue/qtlmap/eQTL_Catalogue_r4/manuscript_sumstats/GTExV8.heart_atrial_appendage_txrev.permuted.txt.gz
GTExV8.heart_left_ventricle_txrev	/gpfs/hpc/projects/eQTLCatalogue/qtlmap/eQTL_Catalogue_r4/manuscript_sumstats/GTExV8.heart_left_ventricle_txrev.nominal.sorted.tsv.gz	/gpfs/hpc/projects/eQTLCatalogue/qtlmap/eQTL_Catalogue_r4/manuscript_sumstats/GTExV8.heart_left_ventricle_txrev.nominal.sorted.tsv.gz.tbi	/gpfs/hpc/projects/eQTLCatalogue/qtlmap/eQTL_Catalogue_r4/manuscript_sumstats/GTExV8.heart_left_ventricle_txrev.permuted.txt.gz
GTExV8.kidney_cortex_txrev	/gpfs/hpc/projects/eQTLCatalogue/qtlmap/eQTL_Catalogue_r4/manuscript_sumstats/GTExV8.kidney_cortex_txrev.nominal.sorted.tsv.gz	/gpfs/hpc/projects/eQTLCatalogue/qtlmap/eQTL_Catalogue_r4/manuscript_sumstats/GTExV8.kidney_cortex_txrev.nominal.sorted.tsv.gz.tbi	/gpfs/hpc/projects/eQTLCatalogue/qtlmap/eQTL_Catalogue_r4/manuscript_sumstats/GTExV8.kidney_cortex_txrev.permuted.txt.gz
GTExV8.liver_txrev	/gpfs/hpc/projects/eQTLCatalogue/qtlmap/eQTL_Catalogue_r4/manuscript_sumstats/GTExV8.liver_txrev.nominal.sorted.tsv.gz	/gpfs/hpc/projects/eQTLCatalogue/qtlmap/eQTL_Catalogue_r4/manuscript_sumstats/GTExV8.liver_txrev.nominal.sorted.tsv.gz.tbi	/gpfs/hpc/projects/eQTLCatalogue/qtlmap/eQTL_Catalogue_r4/manuscript_sumstats/GTExV8.liver_txrev.permuted.txt.gz
GTExV8.lung_txrev	/gpfs/hpc/projects/eQTLCatalogue/qtlmap/eQTL_Catalogue_r4/manuscript_sumstats/GTExV8.lung_txrev.nominal.sorted.tsv.gz	/gpfs/hpc/projects/eQTLCatalogue/qtlmap/eQTL_Catalogue_r4/manuscript_sumstats/GTExV8.lung_txrev.nominal.sorted.tsv.gz.tbi	/gpfs/hpc/projects/eQTLCatalogue/qtlmap/eQTL_Catalogue_r4/manuscript_sumstats/GTExV8.lung_txrev.permuted.txt.gz
GTExV8.minor_salivary_gland_txrev	/gpfs/hpc/projects/eQTLCatalogue/qtlmap/eQTL_Catalogue_r4/manuscript_sumstats/GTExV8.minor_salivary_gland_txrev.nominal.sorted.tsv.gz	/gpfs/hpc/projects/eQTLCatalogue/qtlmap/eQTL_Catalogue_r4/manuscript_sumstats/GTExV8.minor_salivary_gland_txrev.nominal.sorted.tsv.gz.tbi	/gpfs/hpc/projects/eQTLCatalogue/qtlmap/eQTL_Catalogue_r4/manuscript_sumstats/GTExV8.minor_salivary_gland_txrev.permuted.txt.gz
GTExV8.muscle_txrev	/gpfs/hpc/projects/eQTLCatalogue/qtlmap/eQTL_Catalogue_r4/manuscript_sumstats/GTExV8.muscle_txrev.nominal.sorted.tsv.gz	/gpfs/hpc/projects/eQTLCatalogue/qtlmap/eQTL_Catalogue_r4/manuscript_sumstats/GTExV8.muscle_txrev.nominal.sorted.tsv.gz.tbi	/gpfs/hpc/projects/eQTLCatalogue/qtlmap/eQTL_Catalogue_r4/manuscript_sumstats/GTExV8.muscle_txrev.permuted.txt.gz
GTExV8.nerve_tibial_txrev	/gpfs/hpc/projects/eQTLCatalogue/qtlmap/eQTL_Catalogue_r4/manuscript_sumstats/GTExV8.nerve_tibial_txrev.nominal.sorted.tsv.gz	/gpfs/hpc/projects/eQTLCatalogue/qtlmap/eQTL_Catalogue_r4/manuscript_sumstats/GTExV8.nerve_tibial_txrev.nominal.sorted.tsv.gz.tbi	/gpfs/hpc/projects/eQTLCatalogue/qtlmap/eQTL_Catalogue_r4/manuscript_sumstats/GTExV8.nerve_tibial_txrev.permuted.txt.gz
GTExV8.ovary_txrev	/gpfs/hpc/projects/eQTLCatalogue/qtlmap/eQTL_Catalogue_r4/manuscript_sumstats/GTExV8.ovary_txrev.nominal.sorted.tsv.gz	/gpfs/hpc/projects/eQTLCatalogue/qtlmap/eQTL_Catalogue_r4/manuscript_sumstats/GTExV8.ovary_txrev.nominal.sorted.tsv.gz.tbi	/gpfs/hpc/projects/eQTLCatalogue/qtlmap/eQTL_Catalogue_r4/manuscript_sumstats/GTExV8.ovary_txrev.permuted.txt.gz
GTExV8.pancreas_txrev	/gpfs/hpc/projects/eQTLCatalogue/qtlmap/eQTL_Catalogue_r4/manuscript_sumstats/GTExV8.pancreas_txrev.nominal.sorted.tsv.gz	/gpfs/hpc/projects/eQTLCatalogue/qtlmap/eQTL_Catalogue_r4/manuscript_sumstats/GTExV8.pancreas_txrev.nominal.sorted.tsv.gz.tbi	/gpfs/hpc/projects/eQTLCatalogue/qtlmap/eQTL_Catalogue_r4/manuscript_sumstats/GTExV8.pancreas_txrev.permuted.txt.gz
GTExV8.pituitary_txrev	/gpfs/hpc/projects/eQTLCatalogue/qtlmap/eQTL_Catalogue_r4/manuscript_sumstats/GTExV8.pituitary_txrev.nominal.sorted.tsv.gz	/gpfs/hpc/projects/eQTLCatalogue/qtlmap/eQTL_Catalogue_r4/manuscript_sumstats/GTExV8.pituitary_txrev.nominal.sorted.tsv.gz.tbi	/gpfs/hpc/projects/eQTLCatalogue/qtlmap/eQTL_Catalogue_r4/manuscript_sumstats/GTExV8.pituitary_txrev.permuted.txt.gz
GTExV8.prostate_txrev	/gpfs/hpc/projects/eQTLCatalogue/qtlmap/eQTL_Catalogue_r4/manuscript_sumstats/GTExV8.prostate_txrev.nominal.sorted.tsv.gz	/gpfs/hpc/projects/eQTLCatalogue/qtlmap/eQTL_Catalogue_r4/manuscript_sumstats/GTExV8.prostate_txrev.nominal.sorted.tsv.gz.tbi	/gpfs/hpc/projects/eQTLCatalogue/qtlmap/eQTL_Catalogue_r4/manuscript_sumstats/GTExV8.prostate_txrev.permuted.txt.gz
GTExV8.skin_not_sun_exposed_txrev	/gpfs/hpc/projects/eQTLCatalogue/qtlmap/eQTL_Catalogue_r4/manuscript_sumstats/GTExV8.skin_not_sun_exposed_txrev.nominal.sorted.tsv.gz	/gpfs/hpc/projects/eQTLCatalogue/qtlmap/eQTL_Catalogue_r4/manuscript_sumstats/GTExV8.skin_not_sun_exposed_txrev.nominal.sorted.tsv.gz.tbi	/gpfs/hpc/projects/eQTLCatalogue/qtlmap/eQTL_Catalogue_r4/manuscript_sumstats/GTExV8.skin_not_sun_exposed_txrev.permuted.txt.gz
GTExV8.skin_sun_exposed_txrev	/gpfs/hpc/projects/eQTLCatalogue/qtlmap/eQTL_Catalogue_r4/manuscript_sumstats/GTExV8.skin_sun_exposed_txrev.nominal.sorted.tsv.gz	/gpfs/hpc/projects/eQTLCatalogue/qtlmap/eQTL_Catalogue_r4/manuscript_sumstats/GTExV8.skin_sun_exposed_txrev.nominal.sorted.tsv.gz.tbi	/gpfs/hpc/projects/eQTLCatalogue/qtlmap/eQTL_Catalogue_r4/manuscript_sumstats/GTExV8.skin_sun_exposed_txrev.permuted.txt.gz
GTExV8.small_intestine_txrev	/gpfs/hpc/projects/eQTLCatalogue/qtlmap/eQTL_Catalogue_r4/manuscript_sumstats/GTExV8.small_intestine_txrev.nominal.sorted.tsv.gz	/gpfs/hpc/projects/eQTLCatalogue/qtlmap/eQTL_Catalogue_r4/manuscript_sumstats/GTExV8.small_intestine_txrev.nominal.sorted.tsv.gz.tbi	/gpfs/hpc/projects/eQTLCatalogue/qtlmap/eQTL_Catalogue_r4/manuscript_sumstats/GTExV8.small_intestine_txrev.permuted.txt.gz
GTExV8.spleen_txrev	/gpfs/hpc/projects/eQTLCatalogue/qtlmap/eQTL_Catalogue_r4/manuscript_sumstats/GTExV8.spleen_txrev.nominal.sorted.tsv.gz	/gpfs/hpc/projects/eQTLCatalogue/qtlmap/eQTL_Catalogue_r4/manuscript_sumstats/GTExV8.spleen_txrev.nominal.sorted.tsv.gz.tbi	/gpfs/hpc/projects/eQTLCatalogue/qtlmap/eQTL_Catalogue_r4/manuscript_sumstats/GTExV8.spleen_txrev.permuted.txt.gz
GTExV8.stomach_txrev	/gpfs/hpc/projects/eQTLCatalogue/qtlmap/eQTL_Catalogue_r4/manuscript_sumstats/GTExV8.stomach_txrev.nominal.sorted.tsv.gz	/gpfs/hpc/projects/eQTLCatalogue/qtlmap/eQTL_Catalogue_r4/manuscript_sumstats/GTExV8.stomach_txrev.nominal.sorted.tsv.gz.tbi	/gpfs/hpc/projects/eQTLCatalogue/qtlmap/eQTL_Catalogue_r4/manuscript_sumstats/GTExV8.stomach_txrev.permuted.txt.gz
GTExV8.testis_txrev	/gpfs/hpc/projects/eQTLCatalogue/qtlmap/eQTL_Catalogue_r4/manuscript_sumstats/GTExV8.testis_txrev.nominal.sorted.tsv.gz	/gpfs/hpc/projects/eQTLCatalogue/qtlmap/eQTL_Catalogue_r4/manuscript_sumstats/GTExV8.testis_txrev.nominal.sorted.tsv.gz.tbi	/gpfs/hpc/projects/eQTLCatalogue/qtlmap/eQTL_Catalogue_r4/manuscript_sumstats/GTExV8.testis_txrev.permuted.txt.gz
GTExV8.thyroid_txrev	/gpfs/hpc/projects/eQTLCatalogue/qtlmap/eQTL_Catalogue_r4/manuscript_sumstats/GTExV8.thyroid_txrev.nominal.sorted.tsv.gz	/gpfs/hpc/projects/eQTLCatalogue/qtlmap/eQTL_Catalogue_r4/manuscript_sumstats/GTExV8.thyroid_txrev.nominal.sorted.tsv.gz.tbi	/gpfs/hpc/projects/eQTLCatalogue/qtlmap/eQTL_Catalogue_r4/manuscript_sumstats/GTExV8.thyroid_txrev.permuted.txt.gz
GTExV8.uterus_txrev	/gpfs/hpc/projects/eQTLCatalogue/qtlmap/eQTL_Catalogue_r4/manuscript_sumstats/GTExV8.uterus_txrev.nominal.sorted.tsv.gz	/gpfs/hpc/projects/eQTLCatalogue/qtlmap/eQTL_Catalogue_r4/manuscript_sumstats/GTExV8.uterus_txrev.nominal.sorted.tsv.gz.tbi	/gpfs/hpc/projects/eQTLCatalogue/qtlmap/eQTL_Catalogue_r4/manuscript_sumstats/GTExV8.uterus_txrev.permuted.txt.gz
GTExV8.vagina_txrev	/gpfs/hpc/projects/eQTLCatalogue/qtlmap/eQTL_Catalogue_r4/manuscript_sumstats/GTExV8.vagina_txrev.nominal.sorted.tsv.gz	/gpfs/hpc/projects/eQTLCatalogue/qtlmap/eQTL_Catalogue_r4/manuscript_sumstats/GTExV8.vagina_txrev.nominal.sorted.tsv.gz.tbi	/gpfs/hpc/projects/eQTLCatalogue/qtlmap/eQTL_Catalogue_r4/manuscript_sumstats/GTExV8.vagina_txrev.permuted.txt.gz
HipSci.iPSC_txrev	/gpfs/hpc/projects/eQTLCatalogue/qtlmap/eQTL_Catalogue_r4/manuscript_sumstats/HipSci.iPSC_txrev.nominal.sorted.tsv.gz	/gpfs/hpc/projects/eQTLCatalogue/qtlmap/eQTL_Catalogue_r4/manuscript_sumstats/HipSci.iPSC_txrev.nominal.sorted.tsv.gz.tbi	/gpfs/hpc/projects/eQTLCatalogue/qtlmap/eQTL_Catalogue_r4/manuscript_sumstats/HipSci.iPSC_txrev.permuted.txt.gz
Lepik_2017.blood_txrev	/gpfs/hpc/projects/eQTLCatalogue/qtlmap/eQTL_Catalogue_r4/manuscript_sumstats/Lepik_2017.blood_txrev.nominal.sorted.tsv.gz	/gpfs/hpc/projects/eQTLCatalogue/qtlmap/eQTL_Catalogue_r4/manuscript_sumstats/Lepik_2017.blood_txrev.nominal.sorted.tsv.gz.tbi	/gpfs/hpc/projects/eQTLCatalogue/qtlmap/eQTL_Catalogue_r4/manuscript_sumstats/Lepik_2017.blood_txrev.permuted.txt.gz
Nedelec_2016.macrophage_Listeria_txrev	/gpfs/hpc/projects/eQTLCatalogue/qtlmap/eQTL_Catalogue_r4/manuscript_sumstats/Nedelec_2016.macrophage_Listeria_txrev.nominal.sorted.tsv.gz	/gpfs/hpc/projects/eQTLCatalogue/qtlmap/eQTL_Catalogue_r4/manuscript_sumstats/Nedelec_2016.macrophage_Listeria_txrev.nominal.sorted.tsv.gz.tbi	/gpfs/hpc/projects/eQTLCatalogue/qtlmap/eQTL_Catalogue_r4/manuscript_sumstats/Nedelec_2016.macrophage_Listeria_txrev.permuted.txt.gz
Nedelec_2016.macrophage_Salmonella_txrev	/gpfs/hpc/projects/eQTLCatalogue/qtlmap/eQTL_Catalogue_r4/manuscript_sumstats/Nedelec_2016.macrophage_Salmonella_txrev.nominal.sorted.tsv.gz	/gpfs/hpc/projects/eQTLCatalogue/qtlmap/eQTL_Catalogue_r4/manuscript_sumstats/Nedelec_2016.macrophage_Salmonella_txrev.nominal.sorted.tsv.gz.tbi	/gpfs/hpc/projects/eQTLCatalogue/qtlmap/eQTL_Catalogue_r4/manuscript_sumstats/Nedelec_2016.macrophage_Salmonella_txrev.permuted.txt.gz
Nedelec_2016.macrophage_naive_txrev	/gpfs/hpc/projects/eQTLCatalogue/qtlmap/eQTL_Catalogue_r4/manuscript_sumstats/Nedelec_2016.macrophage_naive_txrev.nominal.sorted.tsv.gz	/gpfs/hpc/projects/eQTLCatalogue/qtlmap/eQTL_Catalogue_r4/manuscript_sumstats/Nedelec_2016.macrophage_naive_txrev.nominal.sorted.tsv.gz.tbi	/gpfs/hpc/projects/eQTLCatalogue/qtlmap/eQTL_Catalogue_r4/manuscript_sumstats/Nedelec_2016.macrophage_naive_txrev.permuted.txt.gz
Quach_2016.monocyte_IAV_txrev	/gpfs/hpc/projects/eQTLCatalogue/qtlmap/eQTL_Catalogue_r4/manuscript_sumstats/Quach_2016.monocyte_IAV_txrev.nominal.sorted.tsv.gz	/gpfs/hpc/projects/eQTLCatalogue/qtlmap/eQTL_Catalogue_r4/manuscript_sumstats/Quach_2016.monocyte_IAV_txrev.nominal.sorted.tsv.gz.tbi	/gpfs/hpc/projects/eQTLCatalogue/qtlmap/eQTL_Catalogue_r4/manuscript_sumstats/Quach_2016.monocyte_IAV_txrev.permuted.txt.gz
Quach_2016.monocyte_LPS_txrev	/gpfs/hpc/projects/eQTLCatalogue/qtlmap/eQTL_Catalogue_r4/manuscript_sumstats/Quach_2016.monocyte_LPS_txrev.nominal.sorted.tsv.gz	/gpfs/hpc/projects/eQTLCatalogue/qtlmap/eQTL_Catalogue_r4/manuscript_sumstats/Quach_2016.monocyte_LPS_txrev.nominal.sorted.tsv.gz.tbi	/gpfs/hpc/projects/eQTLCatalogue/qtlmap/eQTL_Catalogue_r4/manuscript_sumstats/Quach_2016.monocyte_LPS_txrev.permuted.txt.gz
Quach_2016.monocyte_Pam3CSK4_txrev	/gpfs/hpc/projects/eQTLCatalogue/qtlmap/eQTL_Catalogue_r4/manuscript_sumstats/Quach_2016.monocyte_Pam3CSK4_txrev.nominal.sorted.tsv.gz	/gpfs/hpc/projects/eQTLCatalogue/qtlmap/eQTL_Catalogue_r4/manuscript_sumstats/Quach_2016.monocyte_Pam3CSK4_txrev.nominal.sorted.tsv.gz.tbi	/gpfs/hpc/projects/eQTLCatalogue/qtlmap/eQTL_Catalogue_r4/manuscript_sumstats/Quach_2016.monocyte_Pam3CSK4_txrev.permuted.txt.gz
Quach_2016.monocyte_R848_txrev	/gpfs/hpc/projects/eQTLCatalogue/qtlmap/eQTL_Catalogue_r4/manuscript_sumstats/Quach_2016.monocyte_R848_txrev.nominal.sorted.tsv.gz	/gpfs/hpc/projects/eQTLCatalogue/qtlmap/eQTL_Catalogue_r4/manuscript_sumstats/Quach_2016.monocyte_R848_txrev.nominal.sorted.tsv.gz.tbi	/gpfs/hpc/projects/eQTLCatalogue/qtlmap/eQTL_Catalogue_r4/manuscript_sumstats/Quach_2016.monocyte_R848_txrev.permuted.txt.gz
Quach_2016.monocyte_naive_txrev	/gpfs/hpc/projects/eQTLCatalogue/qtlmap/eQTL_Catalogue_r4/manuscript_sumstats/Quach_2016.monocyte_naive_txrev.nominal.sorted.tsv.gz	/gpfs/hpc/projects/eQTLCatalogue/qtlmap/eQTL_Catalogue_r4/manuscript_sumstats/Quach_2016.monocyte_naive_txrev.nominal.sorted.tsv.gz.tbi	/gpfs/hpc/projects/eQTLCatalogue/qtlmap/eQTL_Catalogue_r4/manuscript_sumstats/Quach_2016.monocyte_naive_txrev.permuted.txt.gz
ROSMAP.brain_naive_txrev	/gpfs/hpc/projects/eQTLCatalogue/qtlmap/eQTL_Catalogue_r4/manuscript_sumstats/ROSMAP.brain_naive_txrev.nominal.sorted.tsv.gz	/gpfs/hpc/projects/eQTLCatalogue/qtlmap/eQTL_Catalogue_r4/manuscript_sumstats/ROSMAP.brain_naive_txrev.nominal.sorted.tsv.gz.tbi	/gpfs/hpc/projects/eQTLCatalogue/qtlmap/eQTL_Catalogue_r4/manuscript_sumstats/ROSMAP.brain_naive_txrev.permuted.txt.gz
Schmiedel_2018.B-cell_naive_txrev	/gpfs/hpc/projects/eQTLCatalogue/qtlmap/eQTL_Catalogue_r4/manuscript_sumstats/Schmiedel_2018.B-cell_naive_txrev.nominal.sorted.tsv.gz	/gpfs/hpc/projects/eQTLCatalogue/qtlmap/eQTL_Catalogue_r4/manuscript_sumstats/Schmiedel_2018.B-cell_naive_txrev.nominal.sorted.tsv.gz.tbi	/gpfs/hpc/projects/eQTLCatalogue/qtlmap/eQTL_Catalogue_r4/manuscript_sumstats/Schmiedel_2018.B-cell_naive_txrev.permuted.txt.gz
Schmiedel_2018.CD4_T-cell_anti-CD3-CD28_txrev	/gpfs/hpc/projects/eQTLCatalogue/qtlmap/eQTL_Catalogue_r4/manuscript_sumstats/Schmiedel_2018.CD4_T-cell_anti-CD3-CD28_txrev.nominal.sorted.tsv.gz	/gpfs/hpc/projects/eQTLCatalogue/qtlmap/eQTL_Catalogue_r4/manuscript_sumstats/Schmiedel_2018.CD4_T-cell_anti-CD3-CD28_txrev.nominal.sorted.tsv.gz.tbi	/gpfs/hpc/projects/eQTLCatalogue/qtlmap/eQTL_Catalogue_r4/manuscript_sumstats/Schmiedel_2018.CD4_T-cell_anti-CD3-CD28_txrev.permuted.txt.gz
Schmiedel_2018.CD4_T-cell_naive_txrev	/gpfs/hpc/projects/eQTLCatalogue/qtlmap/eQTL_Catalogue_r4/manuscript_sumstats/Schmiedel_2018.CD4_T-cell_naive_txrev.nominal.sorted.tsv.gz	/gpfs/hpc/projects/eQTLCatalogue/qtlmap/eQTL_Catalogue_r4/manuscript_sumstats/Schmiedel_2018.CD4_T-cell_naive_txrev.nominal.sorted.tsv.gz.tbi	/gpfs/hpc/projects/eQTLCatalogue/qtlmap/eQTL_Catalogue_r4/manuscript_sumstats/Schmiedel_2018.CD4_T-cell_naive_txrev.permuted.txt.gz
Schmiedel_2018.CD8_T-cell_anti-CD3-CD28_txrev	/gpfs/hpc/projects/eQTLCatalogue/qtlmap/eQTL_Catalogue_r4/manuscript_sumstats/Schmiedel_2018.CD8_T-cell_anti-CD3-CD28_txrev.nominal.sorted.tsv.gz	/gpfs/hpc/projects/eQTLCatalogue/qtlmap/eQTL_Catalogue_r4/manuscript_sumstats/Schmiedel_2018.CD8_T-cell_anti-CD3-CD28_txrev.nominal.sorted.tsv.gz.tbi	/gpfs/hpc/projects/eQTLCatalogue/qtlmap/eQTL_Catalogue_r4/manuscript_sumstats/Schmiedel_2018.CD8_T-cell_anti-CD3-CD28_txrev.permuted.txt.gz
Schmiedel_2018.CD8_T-cell_naive_txrev	/gpfs/hpc/projects/eQTLCatalogue/qtlmap/eQTL_Catalogue_r4/manuscript_sumstats/Schmiedel_2018.CD8_T-cell_naive_txrev.nominal.sorted.tsv.gz	/gpfs/hpc/projects/eQTLCatalogue/qtlmap/eQTL_Catalogue_r4/manuscript_sumstats/Schmiedel_2018.CD8_T-cell_naive_txrev.nominal.sorted.tsv.gz.tbi	/gpfs/hpc/projects/eQTLCatalogue/qtlmap/eQTL_Catalogue_r4/manuscript_sumstats/Schmiedel_2018.CD8_T-cell_naive_txrev.permuted.txt.gz
Schmiedel_2018.NK-cell_naive_txrev	/gpfs/hpc/projects/eQTLCatalogue/qtlmap/eQTL_Catalogue_r4/manuscript_sumstats/Schmiedel_2018.NK-cell_naive_txrev.nominal.sorted.tsv.gz	/gpfs/hpc/projects/eQTLCatalogue/qtlmap/eQTL_Catalogue_r4/manuscript_sumstats/Schmiedel_2018.NK-cell_naive_txrev.nominal.sorted.tsv.gz.tbi	/gpfs/hpc/projects/eQTLCatalogue/qtlmap/eQTL_Catalogue_r4/manuscript_sumstats/Schmiedel_2018.NK-cell_naive_txrev.permuted.txt.gz
Schmiedel_2018.Tfh_memory_txrev	/gpfs/hpc/projects/eQTLCatalogue/qtlmap/eQTL_Catalogue_r4/manuscript_sumstats/Schmiedel_2018.Tfh_memory_txrev.nominal.sorted.tsv.gz	/gpfs/hpc/projects/eQTLCatalogue/qtlmap/eQTL_Catalogue_r4/manuscript_sumstats/Schmiedel_2018.Tfh_memory_txrev.nominal.sorted.tsv.gz.tbi	/gpfs/hpc/projects/eQTLCatalogue/qtlmap/eQTL_Catalogue_r4/manuscript_sumstats/Schmiedel_2018.Tfh_memory_txrev.permuted.txt.gz
Schmiedel_2018.Th1-17_memory_txrev	/gpfs/hpc/projects/eQTLCatalogue/qtlmap/eQTL_Catalogue_r4/manuscript_sumstats/Schmiedel_2018.Th1-17_memory_txrev.nominal.sorted.tsv.gz	/gpfs/hpc/projects/eQTLCatalogue/qtlmap/eQTL_Catalogue_r4/manuscript_sumstats/Schmiedel_2018.Th1-17_memory_txrev.nominal.sorted.tsv.gz.tbi	/gpfs/hpc/projects/eQTLCatalogue/qtlmap/eQTL_Catalogue_r4/manuscript_sumstats/Schmiedel_2018.Th1-17_memory_txrev.permuted.txt.gz
Schmiedel_2018.Th17_memory_txrev	/gpfs/hpc/projects/eQTLCatalogue/qtlmap/eQTL_Catalogue_r4/manuscript_sumstats/Schmiedel_2018.Th17_memory_txrev.nominal.sorted.tsv.gz	/gpfs/hpc/projects/eQTLCatalogue/qtlmap/eQTL_Catalogue_r4/manuscript_sumstats/Schmiedel_2018.Th17_memory_txrev.nominal.sorted.tsv.gz.tbi	/gpfs/hpc/projects/eQTLCatalogue/qtlmap/eQTL_Catalogue_r4/manuscript_sumstats/Schmiedel_2018.Th17_memory_txrev.permuted.txt.gz
Schmiedel_2018.Th1_memory_txrev	/gpfs/hpc/projects/eQTLCatalogue/qtlmap/eQTL_Catalogue_r4/manuscript_sumstats/Schmiedel_2018.Th1_memory_txrev.nominal.sorted.tsv.gz	/gpfs/hpc/projects/eQTLCatalogue/qtlmap/eQTL_Catalogue_r4/manuscript_sumstats/Schmiedel_2018.Th1_memory_txrev.nominal.sorted.tsv.gz.tbi	/gpfs/hpc/projects/eQTLCatalogue/qtlmap/eQTL_Catalogue_r4/manuscript_sumstats/Schmiedel_2018.Th1_memory_txrev.permuted.txt.gz
Schmiedel_2018.Th2_memory_txrev	/gpfs/hpc/projects/eQTLCatalogue/qtlmap/eQTL_Catalogue_r4/manuscript_sumstats/Schmiedel_2018.Th2_memory_txrev.nominal.sorted.tsv.gz	/gpfs/hpc/projects/eQTLCatalogue/qtlmap/eQTL_Catalogue_r4/manuscript_sumstats/Schmiedel_2018.Th2_memory_txrev.nominal.sorted.tsv.gz.tbi	/gpfs/hpc/projects/eQTLCatalogue/qtlmap/eQTL_Catalogue_r4/manuscript_sumstats/Schmiedel_2018.Th2_memory_txrev.permuted.txt.gz
Schmiedel_2018.Treg_memory_txrev	/gpfs/hpc/projects/eQTLCatalogue/qtlmap/eQTL_Catalogue_r4/manuscript_sumstats/Schmiedel_2018.Treg_memory_txrev.nominal.sorted.tsv.gz	/gpfs/hpc/projects/eQTLCatalogue/qtlmap/eQTL_Catalogue_r4/manuscript_sumstats/Schmiedel_2018.Treg_memory_txrev.nominal.sorted.tsv.gz.tbi	/gpfs/hpc/projects/eQTLCatalogue/qtlmap/eQTL_Catalogue_r4/manuscript_sumstats/Schmiedel_2018.Treg_memory_txrev.permuted.txt.gz
Schmiedel_2018.Treg_naive_txrev	/gpfs/hpc/projects/eQTLCatalogue/qtlmap/eQTL_Catalogue_r4/manuscript_sumstats/Schmiedel_2018.Treg_naive_txrev.nominal.sorted.tsv.gz	/gpfs/hpc/projects/eQTLCatalogue/qtlmap/eQTL_Catalogue_r4/manuscript_sumstats/Schmiedel_2018.Treg_naive_txrev.nominal.sorted.tsv.gz.tbi	/gpfs/hpc/projects/eQTLCatalogue/qtlmap/eQTL_Catalogue_r4/manuscript_sumstats/Schmiedel_2018.Treg_naive_txrev.permuted.txt.gz
Schmiedel_2018.monocyte_CD16_naive_txrev	/gpfs/hpc/projects/eQTLCatalogue/qtlmap/eQTL_Catalogue_r4/manuscript_sumstats/Schmiedel_2018.monocyte_CD16_naive_txrev.nominal.sorted.tsv.gz	/gpfs/hpc/projects/eQTLCatalogue/qtlmap/eQTL_Catalogue_r4/manuscript_sumstats/Schmiedel_2018.monocyte_CD16_naive_txrev.nominal.sorted.tsv.gz.tbi	/gpfs/hpc/projects/eQTLCatalogue/qtlmap/eQTL_Catalogue_r4/manuscript_sumstats/Schmiedel_2018.monocyte_CD16_naive_txrev.permuted.txt.gz
Schmiedel_2018.monocyte_naive_txrev	/gpfs/hpc/projects/eQTLCatalogue/qtlmap/eQTL_Catalogue_r4/manuscript_sumstats/Schmiedel_2018.monocyte_naive_txrev.nominal.sorted.tsv.gz	/gpfs/hpc/projects/eQTLCatalogue/qtlmap/eQTL_Catalogue_r4/manuscript_sumstats/Schmiedel_2018.monocyte_naive_txrev.nominal.sorted.tsv.gz.tbi	/gpfs/hpc/projects/eQTLCatalogue/qtlmap/eQTL_Catalogue_r4/manuscript_sumstats/Schmiedel_2018.monocyte_naive_txrev.permuted.txt.gz
Schwartzentruber_2018.sensory_neuron_txrev	/gpfs/hpc/projects/eQTLCatalogue/qtlmap/eQTL_Catalogue_r4/manuscript_sumstats/Schwartzentruber_2018.sensory_neuron_txrev.nominal.sorted.tsv.gz	/gpfs/hpc/projects/eQTLCatalogue/qtlmap/eQTL_Catalogue_r4/manuscript_sumstats/Schwartzentruber_2018.sensory_neuron_txrev.nominal.sorted.tsv.gz.tbi	/gpfs/hpc/projects/eQTLCatalogue/qtlmap/eQTL_Catalogue_r4/manuscript_sumstats/Schwartzentruber_2018.sensory_neuron_txrev.permuted.txt.gz
TwinsUK.LCL_txrev	/gpfs/hpc/projects/eQTLCatalogue/qtlmap/eQTL_Catalogue_r4/manuscript_sumstats/TwinsUK.LCL_txrev.nominal.sorted.tsv.gz	/gpfs/hpc/projects/eQTLCatalogue/qtlmap/eQTL_Catalogue_r4/manuscript_sumstats/TwinsUK.LCL_txrev.nominal.sorted.tsv.gz.tbi	/gpfs/hpc/projects/eQTLCatalogue/qtlmap/eQTL_Catalogue_r4/manuscript_sumstats/TwinsUK.LCL_txrev.permuted.txt.gz
TwinsUK.blood_txrev	/gpfs/hpc/projects/eQTLCatalogue/qtlmap/eQTL_Catalogue_r4/manuscript_sumstats/TwinsUK.blood_txrev.nominal.sorted.tsv.gz	/gpfs/hpc/projects/eQTLCatalogue/qtlmap/eQTL_Catalogue_r4/manuscript_sumstats/TwinsUK.blood_txrev.nominal.sorted.tsv.gz.tbi	/gpfs/hpc/projects/eQTLCatalogue/qtlmap/eQTL_Catalogue_r4/manuscript_sumstats/TwinsUK.blood_txrev.permuted.txt.gz
TwinsUK.fat_txrev	/gpfs/hpc/projects/eQTLCatalogue/qtlmap/eQTL_Catalogue_r4/manuscript_sumstats/TwinsUK.fat_txrev.nominal.sorted.tsv.gz	/gpfs/hpc/projects/eQTLCatalogue/qtlmap/eQTL_Catalogue_r4/manuscript_sumstats/TwinsUK.fat_txrev.nominal.sorted.tsv.gz.tbi	/gpfs/hpc/projects/eQTLCatalogue/qtlmap/eQTL_Catalogue_r4/manuscript_sumstats/TwinsUK.fat_txrev.permuted.txt.gz
TwinsUK.skin_txrev	/gpfs/hpc/projects/eQTLCatalogue/qtlmap/eQTL_Catalogue_r4/manuscript_sumstats/TwinsUK.skin_txrev.nominal.sorted.tsv.gz	/gpfs/hpc/projects/eQTLCatalogue/qtlmap/eQTL_Catalogue_r4/manuscript_sumstats/TwinsUK.skin_txrev.nominal.sorted.tsv.gz.tbi	/gpfs/hpc/projects/eQTLCatalogue/qtlmap/eQTL_Catalogue_r4/manuscript_sumstats/TwinsUK.skin_txrev.permuted.txt.gz
van_de_Bunt_2015.pancreatic_islet_txrev	/gpfs/hpc/projects/eQTLCatalogue/qtlmap/eQTL_Catalogue_r4/manuscript_sumstats/van_de_Bunt_2015.pancreatic_islet_txrev.nominal.sorted.tsv.gz	/gpfs/hpc/projects/eQTLCatalogue/qtlmap/eQTL_Catalogue_r4/manuscript_sumstats/van_de_Bunt_2015.pancreatic_islet_txrev.nominal.sorted.tsv.gz.tbi	/gpfs/hpc/projects/eQTLCatalogue/qtlmap/eQTL_Catalogue_r4/manuscript_sumstats/van_de_Bunt_2015.pancreatic_islet_txrev.permuted.txt.gz